13,3,3,13,16,19,13,3,3,0
13,6,3,3,6,13,9,3,10,6
6,13,13,3,0,6,13,3,9,13
0,3,6,0,0,3,16,6,13,19
0,3,23,3,0,3,13,3,6,13
0,3,16,3,3,0,3,0,3,3
0,3,13,6,10,3,0,3,10,3
0,0,3,0,6,3,0,3,3,0
0,0,0,3,13,13,6,10,3,0
0,0,0,0,3,3,0,3,0,0
