13,13,3,0,3,23,13,3,3,3
3,6,0,0,3,3,3,6,16,16
6,20,3,3,13,6,3,13,22,19
10,6,0,6,16,13,6,6,19,16
3,0,3,10,6,6,10,6,16,6
0,0,0,6,0,0,3,3,13,3
0,0,3,10,3,0,0,3,3,0
0,0,3,3,0,3,6,13,6,0
0,3,10,3,3,13,16,19,13,3
0,0,3,0,0,3,3,3,3,0
