3,0,3,20,3,0,0,0,0,0
10,3,0,3,3,0,0,0,3,3
3,0,3,6,13,3,0,6,13,13
0,6,13,19,19,6,6,23,6,3
3,10,9,16,22,26,16,16,6,3
0,3,0,6,13,9,3,9,13,23
0,0,0,0,9,20,6,10,9,6
0,0,3,3,10,9,0,6,13,16
0,3,10,3,6,10,3,0,6,23
0,0,3,0,0,3,0,0,0,3
