10,3,3,10,9,13,3,0,0,0
3,0,3,6,13,19,3,0,0,0
0,3,10,6,6,13,3,3,0,3
0,0,9,20,3,3,6,13,6,13
0,3,10,6,0,3,26,16,9,16
0,0,6,3,0,6,26,12,13,26
0,3,23,13,9,13,19,13,6,6
3,0,3,6,10,6,3,3,3,23
10,3,0,0,3,0,0,0,3,13
3,0,0,0,0,0,0,0,0,3
