13,16,16,6,10,6,0,0,0,0
6,6,26,3,6,20,6,0,0,0
13,9,26,3,0,6,10,3,0,3
19,16,16,6,0,0,6,0,6,20
13,6,9,10,6,3,10,6,13,6
3,3,10,12,10,3,3,3,13,3
0,0,6,10,6,0,0,3,3,3
0,0,3,3,0,3,3,13,9,10
0,3,10,3,3,10,6,16,13,6
0,0,3,0,0,3,0,3,3,0
