13,16,13,6,10,6,0,0,3,3
6,6,6,3,6,10,3,6,16,26
16,19,26,13,3,3,3,13,19,16
29,16,6,3,0,0,0,3,3,3
13,6,0,0,0,0,3,0,3,0
3,0,0,0,0,3,10,6,23,6
0,0,3,0,0,0,3,3,16,13
0,6,10,3,0,0,3,0,3,3
3,10,6,0,0,3,10,3,0,0
0,3,0,0,0,0,3,0,0,0
