3,10,3,3,10,3,0,0,0,0
0,3,0,0,3,0,0,3,3,3
3,3,3,0,0,3,3,16,19,16
13,19,13,3,6,10,6,19,19,16
6,13,6,3,10,6,3,16,9,3
3,6,3,0,3,0,3,16,13,6
13,16,13,3,3,0,3,3,9,10
3,3,3,3,10,6,20,6,10,6
0,0,0,0,3,0,3,0,3,0
0,0,0,0,0,0,0,0,0,0
