6,10,3,3,13,6,3,0,0,3
13,6,0,3,29,16,13,6,3,13
13,3,3,3,13,6,9,13,6,23
3,6,10,3,3,6,13,16,3,3
6,13,9,0,3,10,9,3,0,3
13,19,23,3,3,6,13,3,3,20
6,3,3,3,13,9,13,6,0,6
30,3,0,3,16,13,12,10,6,10
3,0,0,0,3,6,10,6,0,3
0,0,0,0,0,0,3,0,0,0
