3,0,3,13,3,6,10,3,0,0
10,3,6,33,6,10,6,0,0,0
3,6,10,6,0,6,0,0,0,0
3,10,6,3,6,10,3,3,3,0
3,6,6,13,13,9,6,16,23,3
13,16,13,6,6,13,16,16,6,0
3,3,6,3,0,3,3,3,3,3
3,3,16,13,6,0,0,6,13,16
10,6,23,9,10,3,3,20,9,13
3,0,3,0,3,0,0,3,0,3
