13,6,3,0,0,0,0,0,0,3
16,19,26,6,3,0,0,0,6,10
6,16,29,16,13,3,0,6,13,6
0,3,6,3,6,0,6,13,16,6
3,3,13,9,10,6,20,9,6,20
10,6,16,23,9,0,6,10,3,3
6,0,3,6,20,3,0,3,0,3
13,3,0,3,3,0,0,0,6,13
13,3,3,10,3,0,0,3,13,16
3,0,0,3,0,0,0,0,3,3
