6,10,3,0,0,0,3,10,3,3
10,6,3,0,0,0,0,3,6,20
6,3,10,6,3,0,0,6,10,6
10,6,6,13,16,6,3,10,6,0
6,23,3,6,19,13,6,3,0,0
3,13,3,6,16,9,10,3,3,0
0,3,3,16,19,3,6,3,10,6
3,0,6,19,19,6,10,3,6,10
10,6,13,29,26,3,3,0,0,3
3,0,3,3,3,0,0,0,0,0
