16,16,6,0,0,3,3,13,16,3
16,39,23,6,3,10,3,9,13,3
3,6,6,10,6,3,3,13,9,0
6,13,3,6,10,3,3,16,13,3
13,16,3,0,6,0,0,3,6,0
6,3,0,3,10,3,3,3,10,3
10,3,0,0,3,6,10,3,6,0
3,3,3,3,3,10,6,3,10,3
3,13,26,23,3,3,0,0,3,0
0,3,3,3,0,0,0,0,0,0
