3,10,3,6,13,3,0,0,3,0
0,3,6,23,19,6,3,6,23,3
3,3,20,12,29,16,16,16,16,3
10,3,9,13,19,9,3,6,3,0
3,3,10,9,19,13,9,13,3,0
0,0,3,3,16,12,13,16,3,3
0,0,3,3,19,26,6,3,3,20
0,6,10,6,26,16,3,3,0,6
3,10,6,0,3,3,3,10,6,10
0,3,0,0,0,0,0,3,0,3
