13,6,0,3,10,6,0,0,0,0
16,13,3,0,6,20,6,0,0,0
6,3,0,3,0,6,10,3,3,0
20,6,6,10,3,0,3,3,10,3
6,13,13,6,0,0,0,0,3,0
3,3,6,0,0,0,0,3,0,3
10,6,13,3,3,3,3,10,6,13
3,3,13,6,13,13,6,3,3,23
0,0,3,0,3,6,10,3,0,3
0,0,0,0,0,0,3,0,0,0
