0,0,3,10,6,3,13,26,3,0
3,0,0,6,10,6,6,16,3,0
10,6,3,0,6,10,6,13,6,0
9,16,26,3,0,6,3,6,13,3
13,19,16,3,3,13,13,6,13,3
3,3,3,0,0,3,3,0,3,0
3,0,0,0,3,0,0,0,0,3
10,6,3,3,13,3,0,0,6,13
6,13,23,6,23,3,0,3,33,16
0,3,3,0,3,0,0,0,3,3
