0,6,10,3,0,0,3,0,3,0
6,10,6,0,0,3,13,6,10,6
10,9,0,3,0,3,13,6,9,10
6,10,9,20,3,3,6,13,13,6
0,6,13,6,6,30,6,3,3,3
0,3,13,6,10,9,13,3,6,10
0,0,3,3,3,3,13,6,10,9
3,3,3,10,3,3,3,0,9,10
23,13,3,3,3,10,3,3,10,6
3,3,0,0,0,3,0,0,3,0
