20,6,0,0,3,3,10,6,0,3
6,13,6,3,10,3,9,20,6,10
3,16,13,3,3,6,10,6,0,6
3,6,3,0,6,10,6,0,6,13
13,13,3,3,13,6,0,3,23,16
3,3,3,3,16,3,0,0,3,6
3,3,10,9,13,6,3,0,3,13
10,3,6,10,9,13,13,3,6,16
3,0,0,3,0,3,3,3,13,16
0,0,0,0,0,0,0,0,3,3
