3,6,13,13,3,0,0,0,0,0
23,26,6,3,3,0,0,3,3,3
6,13,6,6,13,3,3,23,19,13
3,6,13,19,19,3,0,9,13,9
13,3,6,29,16,3,6,13,9,10
23,6,3,13,6,6,16,26,3,3
6,10,3,6,3,16,16,9,0,3
0,6,3,10,6,13,9,10,6,10
3,10,3,3,0,3,0,3,0,3
0,3,0,0,0,0,0,0,0,0
