3,3,3,3,10,3,0,0,0,0
23,16,16,3,6,0,0,0,0,3
6,6,23,9,10,3,0,3,6,13
13,6,6,13,6,0,3,13,16,19
19,13,6,13,3,0,0,3,9,13
13,6,0,6,0,3,3,6,20,6
3,0,6,13,6,16,16,13,6,0
0,6,13,19,9,13,6,6,0,0
3,10,9,16,23,6,3,20,3,0
0,3,0,3,3,0,0,3,0,0
