10,3,6,13,6,20,6,13,13,3
3,6,13,16,3,3,0,6,3,0
3,23,6,3,3,0,3,10,3,3
3,13,3,3,10,6,3,6,6,10
0,3,3,3,9,26,16,16,26,9
0,3,13,26,16,16,6,9,16,23
0,3,3,3,3,3,6,13,9,6
3,10,3,3,0,6,13,19,16,13
0,3,3,20,6,10,6,3,3,3
0,0,0,3,0,3,0,0,0,0
