3,3,20,9,10,3,3,3,3,3
10,3,9,10,6,3,16,19,16,13
3,3,10,9,3,3,19,19,9,3
0,0,6,13,16,6,16,19,13,3
0,0,0,6,13,3,3,3,3,3
3,3,0,0,3,0,0,0,3,10
16,13,3,0,0,0,3,3,0,3
13,6,0,3,3,3,13,16,3,3
3,0,3,13,23,3,6,13,6,10
0,0,0,3,3,0,0,3,0,3
