13,6,13,3,6,10,3,0,0,3
13,9,13,6,20,6,0,0,3,10
6,13,6,0,3,3,0,3,0,3
3,13,3,3,3,10,6,13,3,3
0,3,6,10,3,3,3,13,9,13
0,3,13,6,3,3,3,6,13,16
0,3,13,9,16,29,13,3,3,3
0,0,6,16,19,19,6,3,0,0
0,0,3,13,9,13,6,10,3,0
0,0,0,3,0,3,0,3,0,0
