6,20,6,10,3,0,3,6,10,3
10,6,3,3,0,3,13,13,6,0
6,3,13,3,0,0,6,3,0,0
13,6,13,3,0,6,10,6,0,3
16,6,3,0,3,23,12,13,9,20
19,16,3,3,3,16,16,22,13,9
19,19,6,13,3,3,9,13,12,10
16,16,6,13,6,3,10,9,10,6
3,3,0,6,10,3,3,0,3,0
0,0,0,0,3,0,0,0,0,0
