3,3,3,3,16,23,3,3,23,3
13,19,13,6,16,6,3,3,13,3
9,16,6,3,13,6,10,3,3,3
13,16,3,3,3,0,6,3,3,10
6,6,3,10,6,6,16,13,3,6
16,13,3,6,13,19,19,6,3,10
13,9,0,3,9,26,16,3,0,3
9,13,9,13,13,6,3,0,3,0
13,19,23,6,3,0,0,3,20,3
3,3,3,0,0,0,0,0,3,0
