3,3,3,0,3,0,0,0,0,0
16,16,13,6,13,3,0,0,0,3
16,9,3,3,16,3,0,0,3,20
16,13,3,3,13,3,0,3,3,3
3,3,0,3,3,0,6,13,26,3
0,0,3,13,3,6,10,9,16,3
0,0,6,26,9,13,9,6,16,3
0,3,13,19,19,19,16,16,16,6
0,0,3,6,13,6,3,3,6,10
0,0,0,0,3,0,0,0,0,3
