0,6,10,6,3,13,13,3,3,0
6,13,12,13,3,3,3,3,20,3
13,19,26,16,3,0,0,0,3,0
3,6,3,3,0,0,0,3,0,0
3,10,3,0,0,0,6,10,3,3
3,3,3,0,3,3,10,6,3,13
23,9,10,9,10,6,3,0,3,13
16,13,12,10,9,10,3,0,0,3
3,6,10,6,0,3,0,0,0,0
0,0,3,0,0,0,0,0,0,0
