0,0,3,10,6,20,3,3,20,3
0,3,3,3,0,3,0,3,3,0
6,16,13,6,3,0,3,10,3,0
16,16,9,13,13,3,0,6,0,0
13,6,0,3,3,0,6,13,3,0
6,0,3,0,0,3,13,16,6,3
13,6,10,6,3,0,3,6,13,16
13,6,9,13,23,6,3,0,6,13
6,13,13,6,6,13,13,3,0,3
0,3,3,0,0,3,3,0,0,0
