0,3,3,0,6,13,6,23,16,3
3,16,16,6,16,16,3,6,13,3
3,26,16,6,13,6,0,0,6,0
0,3,3,0,3,0,0,6,10,3
0,3,0,0,3,0,3,13,9,0
3,10,3,6,10,6,3,16,13,3
3,3,6,23,9,10,3,6,6,0
10,6,13,19,6,6,3,13,13,3
3,0,6,16,16,13,3,3,3,0
0,0,0,3,3,3,0,0,0,0
