0,3,10,3,0,0,6,13,23,3
0,0,3,0,3,6,13,6,3,0
0,0,3,3,13,19,19,6,0,0
3,6,10,3,6,19,22,13,3,0
13,13,9,3,3,16,16,6,3,0
6,6,26,13,6,6,6,3,13,6
13,6,16,12,16,19,13,6,26,13
23,6,26,16,19,29,9,0,3,3
3,0,3,3,6,16,13,3,0,0
0,0,0,0,0,3,3,0,0,0
