3,3,10,6,13,16,13,3,0,0
23,3,3,3,3,6,3,0,3,0
13,3,3,10,6,10,3,6,20,3
3,3,0,3,0,6,3,23,6,3
3,13,3,0,3,20,9,16,6,10
3,16,6,0,3,6,13,16,3,3
6,26,13,6,10,6,3,3,3,0
13,6,3,3,6,10,3,6,10,6
13,3,3,10,3,3,3,10,9,10
3,0,0,3,0,0,0,3,0,3
