0,3,26,16,23,6,0,0,0,0
3,3,13,9,9,10,3,3,0,0
10,3,6,16,13,6,3,13,3,0
3,0,6,23,9,0,3,13,3,0
0,3,20,12,10,3,3,6,3,0
3,0,6,10,6,3,23,16,13,6
10,3,0,6,3,3,3,6,6,20
6,3,3,16,19,13,6,10,6,3
13,13,6,16,16,6,0,6,20,3
3,3,0,3,3,0,0,0,3,0
