13,3,0,3,10,3,0,0,0,0
13,6,0,0,3,3,0,0,3,3
9,10,3,0,3,13,6,6,16,13
10,6,3,0,3,16,16,26,16,6
3,3,10,6,0,3,3,6,3,3
3,0,6,10,3,0,6,10,6,23
13,3,0,3,0,3,10,9,3,13
26,3,3,3,0,3,6,10,3,3
13,6,13,13,6,10,3,3,0,0
3,0,3,3,0,3,0,0,0,0
