3,3,6,13,16,13,3,0,3,0
23,16,33,6,3,3,0,3,10,3
6,6,3,0,3,0,0,0,6,0
13,16,3,3,20,3,3,6,13,3
6,13,6,0,3,3,13,26,26,3
0,6,13,3,0,0,3,6,3,3
0,3,13,3,0,0,3,23,6,13
0,3,6,0,0,3,3,26,6,13
3,23,13,3,3,10,6,13,3,3
0,3,3,0,0,3,0,3,0,0
