20,3,0,0,3,0,0,3,10,3
3,3,3,3,10,3,0,0,3,3
3,13,13,3,3,0,3,0,3,10
0,3,3,0,3,3,10,3,0,3
0,0,3,3,13,3,3,0,0,0
3,3,20,6,13,6,3,0,0,3
10,6,3,0,9,26,16,3,6,10
6,10,3,6,13,22,19,6,10,9
0,3,3,10,9,26,16,3,6,10
0,0,0,3,0,3,3,0,0,3
