10,3,6,10,3,0,0,0,3,0
6,6,10,6,0,0,0,6,30,3
13,13,9,3,0,0,6,10,6,0
3,6,23,23,3,6,10,6,0,0
3,0,3,3,6,13,9,0,0,3
13,6,0,6,13,29,13,3,6,10
16,13,9,13,6,6,3,3,10,6
3,6,26,16,9,13,3,3,3,0
0,3,13,9,13,26,6,10,3,0
0,0,3,0,3,3,0,3,0,0
