0,3,16,13,6,3,13,19,13,3
0,3,23,12,13,3,6,16,6,0
0,0,6,26,26,3,3,13,6,0
3,0,6,13,6,0,3,9,10,3
13,6,10,9,0,3,16,13,6,0
13,6,9,10,3,3,13,6,0,0
6,23,16,9,0,3,6,0,0,0
0,6,16,13,6,13,16,3,3,0
0,0,3,3,0,6,13,6,10,3
0,0,0,0,0,0,3,0,3,0
