3,20,3,0,3,10,6,10,3,3
3,3,0,0,3,3,0,3,3,10
13,3,0,3,10,3,0,0,3,3
13,3,0,0,3,3,3,6,10,6
6,3,3,0,6,16,16,13,9,13
13,16,16,6,13,26,6,3,3,23
6,9,23,6,3,6,0,0,3,3
26,16,9,13,6,13,6,6,10,6
16,26,6,13,6,16,16,13,9,10
3,3,0,3,0,3,3,3,0,3
