13,13,3,3,3,0,3,10,3,0
3,3,6,13,16,6,0,3,3,0
3,3,10,9,16,23,3,6,10,3
10,3,3,0,3,6,3,10,6,3
6,0,0,0,6,10,3,3,3,10
13,3,0,3,13,6,0,3,0,6
13,3,3,3,16,3,3,10,9,10
3,3,10,6,16,6,0,6,10,6
0,0,3,3,16,13,3,0,3,0
0,0,0,0,3,3,0,0,0,0
