0,0,3,0,0,3,13,3,3,0
0,3,10,6,3,3,13,6,13,3
0,0,9,26,13,3,3,3,16,3
0,3,13,16,6,3,0,3,13,6
0,0,3,3,3,13,3,0,9,10
0,0,3,0,3,13,3,3,10,9
0,3,10,3,3,3,0,0,9,10
3,0,3,6,10,3,0,6,10,6
10,3,3,10,6,0,3,10,6,0
3,0,0,3,0,0,0,3,0,0
