0,0,3,10,6,3,10,3,0,0
0,0,0,6,13,3,6,0,0,3
0,0,0,6,23,9,10,6,3,10
0,3,6,10,12,20,12,10,3,3
6,16,13,9,13,12,10,6,3,3
13,16,9,3,16,13,6,6,16,16
3,9,13,3,6,3,3,16,19,16
6,23,16,6,10,6,3,13,6,3
10,6,3,0,6,10,3,3,0,0
3,0,0,0,0,3,0,0,0,0
