10,6,3,0,0,0,3,10,3,0
6,23,16,3,3,0,0,3,3,3
0,6,16,6,10,3,0,3,16,23
0,6,13,6,3,0,0,3,13,6
3,10,9,10,3,3,0,0,3,3
0,3,0,3,3,10,6,0,6,10
0,0,0,0,3,6,13,9,13,6
0,0,0,3,20,6,16,16,16,3
0,0,0,0,3,0,3,3,3,0
0,0,0,0,0,0,0,0,0,0
