10,3,0,0,3,0,0,3,3,0
6,0,0,3,10,3,3,16,13,6
13,3,0,0,3,0,6,13,9,10
16,3,0,0,0,3,23,6,0,6
33,3,3,3,0,3,16,3,3,10
3,3,13,23,6,3,16,6,0,3
3,3,6,9,10,6,39,16,3,0
13,19,19,13,6,3,29,16,3,3
6,16,16,6,0,3,13,6,3,10
0,3,3,0,0,0,3,0,0,3
