20,9,23,3,0,0,3,10,3,3
9,13,19,3,0,0,3,3,3,10
10,9,13,3,0,6,10,6,0,3
3,0,3,0,3,10,9,10,3,0
3,0,0,3,3,3,0,3,3,3
13,3,3,16,16,3,0,6,23,16
16,3,3,16,19,3,6,10,9,13
16,6,0,9,13,6,10,6,0,3
16,13,6,10,6,0,3,0,0,0
3,3,0,3,0,0,0,0,0,0
