0,3,20,3,3,3,13,3,0,0
3,3,6,3,13,6,13,3,3,3
23,19,26,6,13,3,3,3,16,13
9,19,16,3,3,0,0,3,16,6
23,26,6,3,0,0,0,6,23,3
6,6,3,10,3,0,6,13,6,0
16,13,3,6,0,3,13,26,6,0
13,6,3,20,6,3,6,6,10,3
3,0,0,6,13,26,13,3,3,0
0,0,0,0,3,3,3,0,0,0
