0,0,3,10,6,10,3,0,0,0
3,0,0,3,3,3,3,0,0,3
13,3,0,3,10,6,10,3,6,10
13,6,0,3,3,0,6,3,10,6
6,23,9,13,3,3,13,3,3,3
3,19,16,16,3,3,23,6,3,13
3,23,6,6,0,0,9,10,6,16
0,6,3,10,6,3,10,6,6,16
3,10,3,6,10,3,3,3,13,26
0,3,0,0,3,0,0,0,3,3
