13,3,6,10,6,0,0,0,0,0
23,9,13,9,20,3,3,0,0,0
6,26,16,6,6,3,10,6,0,3
3,13,9,13,16,3,6,10,9,10
3,3,0,6,13,3,0,9,23,6
20,3,0,0,3,3,3,13,19,3
6,0,0,3,3,20,3,6,16,3
10,3,6,10,3,3,3,6,13,3
3,3,10,6,0,3,13,13,6,0
0,0,3,0,0,0,3,3,0,0
