0,3,10,9,13,6,3,10,3,0
0,3,6,13,22,16,6,3,0,0
6,10,6,6,16,29,23,3,0,0
13,9,20,3,6,6,6,0,0,0
13,6,6,3,16,16,16,6,0,0
6,33,16,9,16,9,26,16,6,0
0,6,19,16,16,6,9,26,16,3
0,6,13,6,6,23,23,9,13,3
3,10,6,0,0,3,3,0,3,0
0,3,0,0,0,0,0,0,0,0
