3,0,3,16,16,6,23,3,0,0
10,6,6,16,16,6,13,6,3,0
6,16,23,6,3,0,6,16,16,3
6,13,6,0,0,0,6,19,16,3
10,6,0,0,0,6,13,16,6,3
3,0,0,0,3,10,9,3,3,10
3,0,3,0,0,6,10,6,0,3
10,6,10,3,0,0,6,10,6,0
3,0,3,0,0,0,0,6,10,3
0,0,0,0,0,0,0,0,3,0
