10,6,3,3,0,0,0,0,0,3
9,13,16,13,6,0,3,0,3,33
13,6,6,6,10,9,13,3,3,16
13,6,13,6,6,13,19,3,3,23
6,3,16,13,3,6,13,3,0,3
10,3,3,3,3,0,6,3,3,0
6,3,3,6,10,6,13,16,23,3
16,19,16,16,9,0,6,3,6,0
16,16,9,16,13,6,10,6,10,3
3,3,0,3,3,0,3,0,3,0
