3,13,16,3,0,3,10,3,3,0
0,9,13,3,0,0,3,3,20,6
3,10,9,0,0,0,3,0,6,20
0,9,10,6,3,3,13,3,0,3
3,23,12,16,16,6,13,6,0,0
3,16,29,22,16,3,9,10,3,0
3,9,16,16,9,3,10,9,0,0
13,13,6,6,13,3,6,10,3,0
3,3,0,3,13,3,0,3,0,0
0,0,0,0,3,0,0,0,0,0
