13,6,10,6,0,0,3,3,0,0
16,3,6,10,3,3,13,13,3,0
13,6,3,3,0,0,3,6,3,3
6,23,16,3,3,0,3,13,16,16
3,9,16,6,10,3,3,6,6,13
13,16,16,3,3,3,13,16,3,6
6,3,3,0,3,3,9,13,6,10
10,3,0,3,16,16,13,6,0,6
3,0,0,3,13,6,3,0,3,20
0,0,0,0,3,0,0,0,0,3
