3,10,3,0,0,0,0,3,0,0
0,3,3,0,3,0,3,20,3,0
3,3,10,6,10,3,0,3,0,0
13,3,3,0,3,0,0,3,0,3
13,3,0,0,3,0,3,13,9,10
6,0,3,3,13,3,3,19,13,6
10,6,13,6,13,6,3,13,9,0
3,3,16,3,6,13,6,6,10,3
0,3,13,3,3,16,13,3,3,0
0,0,3,0,0,3,3,0,0,0
