3,0,0,3,0,3,13,13,3,0
10,3,3,13,3,0,6,6,0,3
3,0,3,16,3,3,13,13,9,10
0,0,3,16,3,0,3,9,13,6
0,0,3,13,3,0,6,16,19,3
3,0,0,3,0,6,16,19,29,3
13,3,3,3,3,13,16,9,13,3
13,6,13,16,6,3,6,0,6,3
3,0,6,26,13,6,10,6,13,13
0,0,0,3,3,0,3,0,3,3
