3,10,9,13,16,23,6,6,10,3
0,6,13,6,6,6,16,16,6,0
0,3,13,6,13,6,26,16,3,0
0,0,3,6,13,3,3,6,3,3
0,3,3,13,9,0,3,16,16,13
3,13,9,19,13,3,3,13,6,3
6,16,16,16,6,0,0,3,0,0
13,6,3,6,0,3,0,3,0,0
13,3,3,10,6,20,6,10,3,0
3,0,0,3,0,3,0,3,0,0
