10,6,3,3,0,0,0,3,0,0
6,16,16,16,3,3,6,13,3,0
3,13,9,13,9,13,29,16,3,3
0,3,3,6,10,9,16,6,3,10
0,3,10,6,6,3,16,3,0,3
0,0,6,13,26,6,16,3,0,0
0,0,3,6,23,6,16,6,0,0
0,6,10,3,6,3,16,13,3,3
3,10,6,3,10,3,3,3,3,10
0,3,0,0,3,0,0,0,0,3
