10,3,3,13,26,6,0,0,3,3
3,3,0,6,19,16,6,3,23,13
3,10,3,3,19,19,13,6,3,6
3,3,0,3,13,6,9,13,6,10
13,6,3,0,3,3,13,19,3,6
19,16,16,6,0,0,6,13,6,13
13,9,16,16,3,0,0,3,3,13
3,3,9,13,3,0,0,0,3,3
3,13,23,6,0,0,0,3,20,3
0,3,3,0,0,0,0,0,3,0
