10,3,3,3,13,3,0,3,0,3
6,3,23,6,13,3,6,10,6,10
10,6,13,6,6,6,10,6,0,3
3,0,6,16,16,13,9,3,0,0
3,0,6,13,9,9,16,13,6,3
20,6,10,12,13,19,16,9,13,16
6,3,6,10,9,26,6,3,6,16
13,13,3,6,6,13,9,10,6,16
3,3,3,13,13,9,10,6,3,13
0,0,0,3,3,0,3,0,0,3
