3,10,3,6,10,3,0,3,0,0
0,3,3,23,9,0,3,10,3,0
3,3,6,26,13,3,0,6,0,3
16,16,16,9,3,0,3,10,6,10
13,9,19,13,6,0,3,6,3,6
6,3,16,9,20,6,13,16,16,16
10,6,13,3,3,3,3,3,6,13
3,3,6,0,6,10,3,3,3,3
3,13,23,6,10,6,3,13,23,3
0,3,3,0,3,0,0,3,3,0
