3,0,0,0,0,0,0,0,0,0
20,3,3,0,0,0,0,0,0,0
3,3,10,3,0,0,0,0,0,0
0,3,6,0,0,3,0,0,0,0
6,16,16,3,3,20,3,0,0,0
13,22,19,3,0,3,0,0,0,0
9,19,29,3,0,0,0,0,0,0
13,19,16,3,0,3,3,3,0,0
3,3,3,0,3,23,26,13,3,0
0,0,0,0,0,3,3,3,0,0
