13,16,23,6,0,0,3,10,3,0
6,6,6,13,6,3,3,6,0,0
13,13,6,29,16,16,16,13,3,3
6,3,3,23,6,3,3,3,6,10
10,3,0,3,0,3,0,6,13,6
3,0,0,0,6,13,6,13,16,3
0,3,0,6,13,16,3,3,3,3
6,10,6,10,6,3,3,3,3,13
10,6,0,3,0,3,13,13,6,13
3,0,0,0,0,0,3,3,0,3
