0,3,13,3,0,3,0,3,0,0
3,3,23,3,3,10,9,10,6,0
10,3,3,3,0,9,10,9,13,3
3,0,6,10,9,10,9,6,13,6
0,3,10,9,10,9,23,16,9,10
3,0,6,0,6,3,6,16,3,3
13,6,10,6,13,13,6,13,3,3
13,6,6,0,3,3,0,3,3,10
6,13,13,3,0,0,0,0,0,3
0,3,3,0,0,0,0,0,0,0
