3,3,3,3,10,3,0,3,0,3
16,19,13,3,3,0,6,13,6,10
29,19,6,0,3,3,13,16,3,6
16,16,3,3,10,3,3,3,3,10
3,3,0,0,6,3,0,3,0,3
0,0,0,3,13,13,6,13,3,0
3,0,0,0,3,3,3,13,3,0
13,6,3,0,0,0,3,6,3,0
16,16,13,3,0,3,23,16,13,3
3,3,3,0,0,0,3,3,3,0
