13,13,3,3,0,0,0,3,10,3
6,6,3,10,6,0,0,0,3,0
13,13,3,6,10,3,3,0,3,0
6,3,3,0,6,6,10,6,10,3
10,6,13,6,16,13,6,0,3,0
3,3,13,6,16,9,0,3,0,0
0,0,3,3,19,13,6,10,3,3
0,3,0,3,13,6,0,3,6,10
3,10,3,0,3,0,0,3,10,6
0,3,0,0,0,0,0,0,3,0
