26,16,3,3,3,10,3,0,0,0
16,16,6,10,6,3,3,3,3,0
3,6,0,6,10,6,13,16,13,3
3,13,6,0,3,3,3,3,3,0
3,16,13,6,6,20,3,0,0,0
0,3,6,13,16,9,3,0,3,0
3,0,0,9,16,19,16,9,10,6
10,3,6,10,9,19,22,13,9,10
3,3,10,6,3,16,16,6,0,3
0,0,3,0,0,3,3,0,0,0
