3,10,3,0,3,10,9,16,13,3
0,6,0,0,3,9,13,16,6,3
6,10,3,3,16,16,6,6,6,20
13,6,3,6,16,16,6,16,13,9
13,6,13,13,6,3,3,13,9,10
6,0,3,3,0,0,3,3,3,3
10,3,3,0,3,6,10,6,10,3
3,6,10,6,13,13,9,3,3,0
3,10,6,0,3,6,13,13,3,0
0,3,0,0,0,0,3,3,0,0
