0,3,20,3,6,10,3,0,0,0
0,0,3,6,13,6,3,3,0,0
3,0,3,23,16,6,16,23,6,0
13,6,0,3,6,3,13,12,20,3
16,13,3,6,13,3,9,13,6,3
6,3,3,13,26,9,13,16,9,20
20,6,0,3,6,23,9,6,20,6
9,13,3,0,3,26,13,3,6,3
13,16,3,0,0,3,3,3,13,13
3,3,0,0,0,0,0,0,3,3
