10,3,3,0,0,0,3,13,16,3
6,3,10,6,0,0,0,6,13,3
13,3,6,13,3,3,0,3,6,3
16,6,3,13,9,10,6,16,16,13
26,13,6,6,10,6,3,13,6,3
6,9,10,3,3,0,0,3,0,0
23,13,6,0,0,0,0,3,3,0
3,6,0,3,0,0,6,23,16,6
3,20,6,10,3,3,10,9,16,13
0,3,0,3,0,0,3,0,3,3
