3,3,0,0,0,0,3,6,10,3
16,13,3,0,0,3,13,13,6,0
13,9,0,3,0,3,3,3,0,0
9,13,9,20,6,10,3,0,0,0
16,19,16,9,0,3,3,0,3,3
23,9,16,16,6,6,10,6,13,13
3,3,6,19,19,13,9,3,3,3
6,10,6,16,19,12,16,16,3,3
20,6,0,6,16,16,19,26,6,10
3,0,0,0,3,3,3,3,0,3
