3,20,6,13,23,3,3,20,3,3
3,3,0,6,3,3,0,3,3,10
10,3,6,13,6,13,3,0,3,3
3,3,16,19,6,13,3,3,10,3
0,3,29,19,3,3,0,0,3,0
3,3,29,16,3,0,3,0,0,0
10,9,13,6,0,6,13,3,0,0
6,20,6,3,6,13,19,3,0,0
0,3,3,13,13,9,13,3,0,0
0,0,0,3,3,0,3,0,0,0
