0,3,13,16,13,6,3,10,3,0
0,0,3,6,9,10,6,3,3,0
3,3,3,13,23,9,10,6,13,6
26,16,3,6,3,0,3,3,16,13
26,19,6,10,6,3,3,3,6,3
6,13,6,9,13,16,16,26,33,3
3,9,13,13,9,3,6,3,6,3
13,13,9,6,10,9,13,6,16,23
3,6,10,3,6,13,16,6,13,6
0,0,3,0,0,3,3,0,3,0
