16,13,6,13,3,3,13,6,0,0
23,6,3,23,3,3,16,13,3,3
6,0,0,6,0,3,6,3,6,10
13,3,3,10,6,13,13,6,10,6
16,3,0,3,3,3,3,0,6,0
13,3,3,6,13,6,3,3,10,3
6,3,13,16,32,19,13,3,6,0
10,6,3,6,16,16,9,3,13,3
6,10,3,0,3,6,30,6,13,3
0,3,0,0,0,0,3,0,3,0
