3,6,10,3,3,3,10,3,0,0
13,13,9,3,10,3,6,3,3,0
3,9,13,3,3,3,16,19,23,6
3,13,16,3,3,6,16,19,12,10
0,3,3,3,13,13,9,19,13,9
3,0,0,0,3,3,3,13,9,10
10,3,3,3,0,0,0,3,3,3
6,3,13,23,3,3,0,3,10,3
10,3,3,3,3,10,3,0,3,0
3,0,0,0,0,3,0,0,0,0
