10,3,0,3,10,6,6,10,3,3
6,0,0,3,6,13,13,6,3,23
13,3,3,20,3,3,3,3,6,23
13,6,0,3,0,3,3,16,13,9
9,10,6,0,6,13,9,16,9,13
20,12,10,6,13,19,19,16,6,13
6,10,9,3,6,6,13,6,0,3
0,9,16,29,23,3,3,3,0,0
3,13,29,16,6,0,3,20,3,0
0,3,3,3,0,0,0,3,0,0
