0,0,0,0,0,0,3,10,3,0
0,0,0,0,0,0,3,3,3,0
0,0,3,0,3,3,13,6,10,3
3,6,23,6,10,6,23,3,3,3
13,16,16,6,3,0,6,0,3,13
3,3,6,13,6,6,10,6,3,13
0,0,3,19,16,13,9,10,3,3
3,0,6,13,6,3,0,6,0,3
10,6,10,6,0,0,3,10,6,10
3,0,3,0,0,0,0,3,0,3
