13,16,6,6,13,3,3,0,0,0
9,16,16,16,16,6,10,6,0,3
23,6,3,6,3,0,6,10,6,10
13,6,6,10,3,0,3,3,3,3
6,13,13,6,0,3,10,9,13,3
0,3,3,0,3,3,6,13,16,6
3,0,3,3,13,13,6,3,6,13
13,6,20,6,3,6,20,3,3,16
13,3,6,10,3,0,3,0,3,13
3,0,0,3,0,0,0,0,0,3
