3,3,0,0,3,0,6,13,6,0
13,13,3,6,13,9,13,22,13,3
6,6,6,13,19,16,9,13,6,3
16,26,13,6,6,13,3,3,3,10
13,9,3,3,0,3,0,0,3,3
6,13,6,13,3,0,0,3,10,3
3,13,9,13,3,0,0,0,3,0
0,6,10,6,3,3,0,0,0,0
0,0,3,3,13,13,3,0,0,0
0,0,0,0,3,3,0,0,0,0
