0,6,13,3,0,0,0,3,0,0
3,16,19,6,0,0,3,13,6,0
3,16,19,13,3,0,3,19,13,3
0,3,3,3,0,0,3,16,9,0
3,3,3,0,0,0,3,16,13,3
26,19,16,6,0,0,0,3,3,3
19,19,29,23,3,0,3,0,6,10
23,6,3,6,3,6,10,9,20,6
3,0,3,13,16,13,9,10,6,0
0,0,0,3,3,3,0,3,0,0
