13,13,6,6,13,3,3,13,3,0
6,6,13,19,19,3,6,26,3,0
10,3,6,19,26,6,13,16,3,0
3,0,6,16,9,3,3,3,0,3
0,6,13,19,16,13,3,3,3,13
6,10,9,6,6,3,6,10,6,13
13,12,13,19,16,6,10,6,3,6
19,13,9,19,19,3,3,6,16,13
13,6,3,26,16,3,3,13,26,6
3,0,0,3,3,0,0,3,3,0
