10,6,0,6,10,3,0,0,0,0
9,13,6,10,6,3,3,0,0,0
13,16,3,3,3,13,16,6,0,0
6,6,3,0,0,6,16,16,3,3
13,16,26,3,0,3,6,16,9,10
3,9,23,3,3,10,9,16,13,6
3,10,6,0,3,6,10,9,3,0
3,3,0,3,10,6,6,20,3,0
10,3,0,0,6,10,3,3,0,0
3,0,0,0,0,3,0,0,0,0
