3,0,3,3,3,3,3,3,3,0
10,6,16,19,16,16,16,29,13,3
3,3,19,16,6,3,6,16,6,0
0,3,26,9,3,3,6,13,3,0
3,6,29,16,16,29,23,6,0,0
13,16,26,6,9,23,6,0,0,0
3,3,6,3,10,6,3,3,3,0
0,6,13,3,3,6,13,16,13,3
3,13,16,3,3,10,6,3,3,0
0,3,3,0,0,3,0,0,0,0
