13,13,3,6,13,3,0,6,23,3
6,3,3,26,19,6,3,13,16,3
10,6,3,16,19,13,3,6,3,0
9,13,3,3,3,3,6,10,3,3
13,19,3,3,0,6,10,6,3,10
6,13,6,10,6,23,6,0,0,3
0,3,0,3,3,23,3,0,0,0
3,0,0,0,0,3,0,3,0,0
10,3,0,0,0,0,3,10,3,0
3,0,0,0,0,0,0,3,0,0
