0,0,3,10,6,0,3,10,3,0
0,0,0,9,10,3,0,3,0,3
3,0,3,13,6,0,0,3,6,20
10,6,3,16,3,3,6,13,16,6
6,10,6,13,6,23,13,9,13,6
3,3,0,6,0,3,3,0,6,20
20,3,3,10,3,3,0,0,0,3
3,3,3,3,3,10,3,3,0,0
3,13,13,3,0,3,3,10,3,0
0,3,3,0,0,0,0,3,0,0
