3,13,16,13,3,3,13,16,26,3
0,3,3,3,0,0,3,6,13,3
0,3,0,3,0,0,0,0,3,0
3,10,9,20,3,3,0,3,0,3
3,9,13,6,6,10,9,10,6,20
13,16,29,6,10,9,13,9,0,3
3,6,13,3,6,6,16,13,6,0
3,0,6,3,23,16,9,9,20,3
10,6,10,3,6,16,16,13,6,0
3,0,3,0,0,3,3,3,0,0
