10,6,0,3,0,3,3,3,0,0
6,10,6,10,9,13,16,13,3,0
0,6,3,6,13,6,6,6,0,0
3,16,16,6,26,6,16,13,3,3
3,16,19,9,13,6,16,6,3,10
0,6,19,13,6,3,13,3,0,3
0,3,16,6,0,3,3,3,0,3
0,6,13,6,3,13,6,10,6,13
3,20,9,10,6,13,3,3,3,13
0,3,0,3,0,3,0,0,0,3
