6,20,6,10,3,0,3,13,3,0
20,6,0,3,3,0,3,13,6,0
3,0,3,6,13,6,0,6,10,3
3,6,13,16,19,16,3,0,6,3
16,13,6,3,6,13,6,3,13,13
13,9,0,3,3,6,13,3,3,3
9,10,6,13,13,6,26,3,0,0
10,6,0,6,3,3,13,3,0,0
3,0,3,10,3,0,3,0,0,0
0,0,0,3,0,0,0,0,0,0
