16,13,3,0,0,3,6,13,3,0
13,9,3,0,3,13,19,16,3,3
9,13,16,6,0,9,16,6,3,10
10,9,19,16,6,13,16,3,0,3
3,3,19,16,3,3,3,3,3,0
3,3,16,9,3,0,3,23,13,6
10,6,16,16,16,6,0,3,6,10
3,3,3,6,26,16,3,0,3,3
3,10,3,0,6,13,3,3,10,3
0,3,0,0,0,3,0,0,3,0
