0,3,13,6,13,16,16,3,0,0
3,3,16,6,3,9,16,3,0,0
13,6,16,13,6,16,16,6,3,0
16,3,3,3,3,26,9,13,13,3
13,3,3,3,3,16,3,3,3,0
3,3,23,13,6,13,3,0,3,3
0,3,6,3,0,3,0,3,13,13
3,13,23,3,0,0,0,0,3,6
0,3,3,0,0,0,0,0,3,10
0,0,0,0,0,0,0,0,0,3
