10,3,6,13,6,13,3,0,0,0
6,3,13,19,9,13,6,3,0,0
13,3,9,16,13,9,16,13,3,0
13,6,10,6,3,3,13,6,0,0
3,0,3,0,0,0,3,3,0,0
3,0,3,0,3,3,3,10,3,0
10,9,10,6,13,16,3,3,0,0
9,10,9,0,6,16,3,0,0,0
20,9,30,3,3,13,3,0,0,0
3,0,3,0,0,3,0,0,0,0
