3,3,0,3,20,3,3,26,16,3
16,13,3,0,6,0,6,29,29,3
26,6,0,6,10,6,13,22,16,3
13,6,3,10,6,3,6,13,6,0
6,13,3,3,6,10,3,6,3,0
6,16,3,3,10,6,3,16,13,6
23,16,6,0,3,0,3,13,9,10
3,6,10,3,0,0,3,3,3,3
0,0,3,0,0,3,10,6,10,3
0,0,0,0,0,0,3,0,3,0
