0,0,0,3,0,0,0,0,0,0
0,0,3,10,3,0,0,3,0,0
0,3,0,3,3,0,6,20,3,0
3,13,3,6,20,9,10,6,0,3
3,23,9,10,9,20,6,3,3,10
0,9,10,6,0,3,3,10,3,3
3,10,6,0,0,0,3,3,3,3
0,3,0,3,0,3,23,6,13,13
0,0,3,10,3,3,13,3,3,3
0,0,0,3,0,0,3,0,0,0
