0,0,0,3,3,10,3,3,3,0
0,0,3,13,3,3,6,16,13,3
0,0,6,13,6,3,16,26,6,3
3,3,10,9,10,6,13,9,3,10
10,3,3,0,6,0,6,10,3,3
6,3,0,3,13,3,0,3,0,3
13,16,3,3,13,6,0,0,3,10
9,13,3,0,6,10,3,0,3,3
10,6,0,0,0,3,0,3,10,3
3,0,0,0,0,0,0,0,3,0
