3,0,6,13,3,3,3,0,0,3
23,6,13,26,6,13,16,6,3,10
13,3,3,3,0,6,16,13,3,3
3,0,0,0,0,0,6,3,3,3
3,0,0,0,0,3,23,9,13,23
10,3,0,0,3,3,19,13,9,3
3,3,3,3,13,6,16,9,13,6
3,13,13,6,13,6,23,6,36,23
0,3,3,0,3,0,3,0,3,3
0,0,0,0,0,0,0,0,0,0
