3,3,3,0,3,3,13,3,0,0
16,16,13,6,13,6,16,3,3,0
13,9,6,3,23,9,13,6,10,6
6,13,16,3,6,13,6,0,6,10
0,6,13,3,3,23,3,3,0,3
3,0,6,0,0,6,6,13,6,3
13,6,10,6,6,13,16,22,19,13
16,6,6,13,13,6,6,16,16,9
26,23,3,3,3,0,0,3,6,10
3,3,0,0,0,0,0,0,0,3
