20,6,10,6,13,3,0,3,3,3
3,3,3,3,13,3,3,16,19,13
3,10,3,0,6,3,3,16,19,6
0,6,3,3,13,13,3,6,13,3
3,13,13,3,6,6,3,0,3,0
0,3,3,6,13,19,23,3,0,0
0,3,3,10,12,13,6,3,0,0
3,10,3,6,10,9,3,10,3,3
0,3,0,0,6,10,3,3,3,10
0,0,0,0,0,3,0,0,0,3
