6,10,9,16,23,3,0,0,0,3
10,9,13,16,6,3,3,0,6,10
3,0,3,3,3,13,16,6,10,6
0,3,0,0,3,6,13,6,3,0
6,13,6,6,10,6,6,10,3,0
23,19,16,13,9,10,3,6,0,0
3,3,3,3,3,3,6,13,6,0
3,0,0,3,13,9,13,22,16,6
20,3,0,3,26,13,9,16,19,13
3,0,0,0,3,3,0,3,3,3
