0,3,0,3,10,3,0,0,3,3
6,10,6,3,3,0,0,3,16,16
20,9,13,13,3,3,3,3,16,19
3,0,6,3,3,13,16,6,6,13
0,3,13,3,3,6,16,16,3,3
0,3,16,9,13,6,6,26,3,0
3,3,16,26,22,13,6,13,3,0
10,3,3,6,16,9,3,3,0,3
3,0,0,3,16,16,13,3,3,10
0,0,0,0,3,3,3,0,0,3
