16,16,26,13,9,10,3,3,13,3
13,9,6,6,10,6,3,3,26,3
6,16,13,3,6,3,10,6,16,3
6,16,6,3,20,3,3,6,13,3
16,29,6,0,3,0,3,20,6,0
29,19,13,3,0,3,0,3,0,0
23,6,3,0,6,10,3,0,0,0
6,0,0,6,10,6,3,0,3,0
10,3,3,10,6,3,10,6,10,3
3,0,0,3,0,0,3,0,3,0
