3,13,16,9,20,3,3,10,3,0
0,9,16,13,6,0,0,3,3,3
6,10,6,6,0,0,3,6,13,13
20,6,3,13,3,3,13,16,6,6
3,3,6,13,6,3,6,16,6,10
6,13,13,9,13,16,6,13,3,6
10,6,3,3,6,13,3,6,6,10
3,0,3,10,3,6,3,13,16,6
0,0,0,3,3,10,3,6,13,3
0,0,0,0,0,3,0,0,3,0
