0,3,13,6,10,9,13,6,0,3
0,3,26,6,6,13,19,16,6,13
0,3,16,23,3,3,9,13,6,13
0,3,6,6,3,6,23,6,3,3
3,13,19,16,19,26,29,6,10,3
0,6,13,9,13,12,13,3,6,0
0,0,6,0,6,20,9,3,13,3
0,6,10,3,0,6,10,6,26,3
3,10,6,0,0,0,3,3,23,3
0,3,0,0,0,0,0,0,3,0
