13,3,0,6,13,3,3,13,3,0
23,6,6,13,19,3,3,16,3,0
6,13,16,12,13,6,6,16,3,3
0,6,19,13,9,13,29,16,6,10
3,3,13,6,0,6,13,6,0,3
10,6,6,0,0,0,3,3,0,0
6,13,13,3,0,3,6,20,6,0
0,3,3,0,3,33,23,9,10,3
0,0,0,0,0,3,3,0,3,0
0,0,0,0,0,0,0,0,0,0
