6,13,13,6,0,0,0,0,0,3
13,9,6,10,3,3,0,0,6,10
19,16,3,6,3,23,6,3,10,9
19,19,6,13,9,19,13,6,6,13
26,29,9,19,26,16,9,10,6,13
6,16,26,19,6,3,3,3,0,3
0,3,6,26,3,3,13,3,0,3
0,0,3,16,3,3,23,3,6,10
0,0,3,13,3,0,3,3,10,6
0,0,0,3,0,0,0,0,3,0
