10,6,0,0,0,3,20,3,0,0
9,10,3,3,0,0,6,0,0,3
13,9,6,13,6,3,13,3,3,10
19,16,19,32,13,9,13,6,3,3
26,9,19,16,9,13,12,23,13,3
13,6,13,6,3,16,16,6,6,3
6,0,3,0,0,9,13,6,16,16
10,3,3,0,6,10,6,6,16,16
3,3,10,6,10,6,3,10,6,3
0,0,3,0,3,0,0,3,0,0
