3,0,0,0,3,3,13,23,3,0
20,6,0,3,10,3,3,6,0,0
6,13,3,0,3,3,3,20,6,0
3,13,3,0,6,10,3,6,20,3
0,6,0,3,13,6,3,3,6,3
3,13,6,3,13,6,23,16,16,16
3,16,16,6,3,3,6,6,6,23
0,9,16,13,6,13,36,13,3,3
3,10,6,3,0,3,3,3,0,0
0,3,0,0,0,0,0,0,0,0
