20,6,3,0,0,0,0,0,3,0
6,16,13,3,3,0,3,3,10,6
3,13,6,6,23,9,13,6,6,10
3,6,6,16,29,19,32,13,3,3
13,19,16,26,9,19,16,9,0,0
9,13,6,6,3,16,9,13,3,0
10,6,3,10,9,13,9,16,6,0
3,3,0,9,10,9,13,19,13,3
3,10,6,10,6,0,3,3,3,0
0,3,0,3,0,0,0,0,0,0
