0,3,10,6,23,23,3,0,3,0
3,0,3,0,3,6,0,6,10,3
13,3,0,0,6,10,6,10,6,0
13,3,0,3,10,6,3,6,0,0
6,3,0,0,3,3,16,13,3,3
13,16,6,0,0,3,13,6,3,10
9,26,13,3,3,0,3,3,3,6
10,6,3,3,10,3,6,16,16,16
3,0,0,0,3,3,13,16,9,13
0,0,0,0,0,0,3,3,0,3
