0,0,3,13,3,0,3,3,23,3
3,0,6,13,6,3,10,6,26,3
10,9,10,9,10,3,3,3,26,3
6,13,6,0,3,0,0,6,13,3
3,16,3,0,3,0,6,20,9,0
3,26,3,3,10,6,10,9,10,3
6,13,6,0,3,0,3,0,3,3
13,12,10,3,0,3,0,0,3,20
16,13,6,0,3,10,3,0,0,3
3,3,0,0,0,3,0,0,0,0
