0,0,0,3,3,20,6,0,0,0
3,0,6,13,3,6,23,3,0,0
10,6,16,16,3,3,13,3,3,3
3,3,13,6,0,3,6,3,13,16
3,0,3,0,6,13,13,3,9,13
10,3,0,6,20,6,3,3,23,6
6,0,3,10,6,0,0,3,13,3
10,6,0,3,0,3,0,0,3,0
6,10,3,0,3,20,3,0,0,0
0,3,0,0,0,3,0,0,0,0
