26,16,13,6,0,0,0,3,0,0
16,9,6,20,3,0,3,20,3,0
19,16,6,3,3,0,0,3,3,0
16,22,13,6,13,6,3,3,33,3
6,13,9,6,19,19,13,9,16,3
0,6,23,19,19,16,12,16,16,3
3,0,6,16,6,9,26,16,6,3
10,3,3,23,6,16,16,6,3,10
3,0,0,3,3,13,6,0,0,3
0,0,0,0,0,3,0,0,0,0
