3,3,0,3,13,6,10,3,0,3
13,13,3,6,23,3,3,0,3,10
3,3,3,13,9,0,3,3,0,3
0,0,3,16,13,6,13,13,3,0
3,0,0,3,3,0,3,3,3,0
10,6,0,0,3,0,0,3,13,3
9,10,3,3,10,3,3,6,13,3
10,9,0,0,6,3,23,16,9,0
6,10,3,3,20,3,6,16,13,3
0,3,0,0,3,0,0,3,3,0
