0,6,13,6,10,6,3,0,3,0
3,13,16,6,6,26,23,6,20,3
0,3,6,10,6,13,9,0,3,0
0,3,0,6,0,6,23,3,0,0
3,13,6,10,3,6,13,3,0,0
3,13,3,3,6,10,6,0,0,0
3,3,0,6,13,9,3,3,0,0
20,3,3,23,22,16,26,16,3,0
3,0,0,6,13,6,6,13,3,0
0,0,0,0,3,0,0,3,0,0
