3,13,3,0,0,0,3,0,0,3
3,13,3,3,0,3,10,3,6,13
0,3,3,13,3,3,3,6,13,16
0,3,3,16,6,13,6,10,6,6
6,10,6,13,6,13,3,3,3,10
13,6,0,3,0,3,0,3,3,3
23,3,0,0,3,0,3,13,13,3
6,0,0,6,13,3,0,3,6,0
10,3,3,13,26,3,0,3,10,3
3,0,0,3,3,0,0,0,3,0
