3,0,3,10,6,13,26,13,3,3
13,6,0,3,0,3,3,3,3,20
16,13,3,3,0,0,0,0,0,3
6,3,6,10,3,3,0,0,3,3
10,6,10,9,6,10,3,3,13,13
3,0,6,13,16,6,3,3,6,3
0,0,3,6,13,9,13,16,13,3
0,3,13,6,9,20,6,3,3,0
0,3,16,16,13,6,0,0,0,0
0,0,3,3,3,0,0,0,0,0
