13,9,13,16,13,6,10,6,0,0
19,16,9,6,3,3,6,10,3,0
16,19,16,16,6,13,3,3,3,0
3,6,6,16,6,16,3,6,13,3
3,10,6,23,9,13,6,16,19,3
0,6,3,6,10,6,6,19,26,3
6,23,13,6,3,3,16,19,6,0
10,6,6,10,6,3,19,16,3,0
3,0,0,6,20,6,13,6,0,0
0,0,0,0,3,0,3,0,0,0
