13,3,3,0,3,3,0,3,10,3
16,6,10,6,13,13,3,0,3,3
13,6,3,0,3,6,3,0,3,13
6,10,3,0,3,16,16,6,3,13
3,3,0,0,3,29,32,16,3,3
10,3,0,0,3,26,39,16,3,0
6,0,0,0,0,6,3,6,0,0
10,3,3,0,3,10,6,20,6,0
3,3,10,3,0,3,0,6,10,3
0,0,3,0,0,0,0,0,3,0
