0,0,3,3,10,6,10,3,0,0
0,3,13,3,6,3,3,0,0,0
0,6,13,9,13,23,6,0,0,3
6,10,9,10,6,6,23,3,6,30
10,6,3,6,0,6,23,6,10,9
3,3,13,13,9,20,6,0,6,10
0,0,6,9,10,9,0,0,0,3
0,3,16,13,9,10,3,3,0,3
0,3,13,6,0,3,3,10,6,10
0,0,3,0,0,0,0,3,0,3
