0,0,0,0,0,3,3,0,0,3
0,3,0,3,3,13,13,6,6,13
6,10,6,10,3,3,6,13,16,29
20,6,0,3,0,0,3,6,9,13
3,0,3,3,3,3,23,16,13,6
0,3,16,16,16,3,3,6,3,0
0,3,13,9,13,3,3,20,3,0
0,0,3,3,3,0,0,3,0,0
0,0,3,10,3,0,0,0,0,0
0,0,0,3,0,0,0,0,0,0
