13,3,3,10,6,10,3,0,0,0
16,3,3,3,0,3,3,0,3,0
16,6,13,6,0,3,20,6,10,3
13,6,16,13,3,3,3,0,3,0
6,0,3,3,3,10,3,0,3,3
10,6,0,0,0,6,0,3,13,13
6,20,6,0,3,10,3,0,3,3
0,6,10,3,3,3,0,0,0,3
0,0,3,3,20,3,0,0,3,10
0,0,0,0,3,0,0,0,0,3
