0,3,3,6,10,6,6,10,3,3
6,13,16,13,12,13,13,6,3,20
10,6,6,6,10,9,3,0,0,6
3,6,10,3,6,10,6,0,3,10
3,13,6,0,0,6,10,3,0,3
3,16,3,0,0,0,3,3,0,3
3,13,6,0,0,0,3,10,9,13
3,6,10,6,3,0,0,6,13,19
10,3,6,13,13,3,0,0,6,23
3,0,0,3,3,0,0,0,0,3
