0,0,0,6,10,3,3,10,3,0
0,0,3,10,6,0,0,6,3,0
0,3,3,3,0,0,3,13,13,3
3,13,13,6,0,3,3,6,3,0
0,3,6,13,9,13,16,13,3,0
0,3,3,16,23,6,3,6,3,0
6,13,3,6,3,3,6,13,13,3
13,16,9,13,9,16,13,6,6,0
3,6,13,19,16,16,6,3,10,3
0,0,3,3,3,3,0,0,3,0
