0,3,0,3,3,0,0,3,3,3
3,10,6,16,13,3,3,16,16,23
0,6,6,13,6,3,3,16,9,3
6,13,26,6,6,20,6,16,13,6
10,9,26,6,13,6,0,3,6,10
3,3,16,6,13,3,0,0,0,3
0,3,16,6,3,0,0,0,3,3
3,6,16,13,3,3,0,6,13,16
13,13,6,3,3,10,6,10,9,13
3,3,0,0,0,3,0,3,0,3
