0,0,0,0,0,3,3,13,3,0
3,3,0,0,3,10,6,13,6,0
13,16,3,0,3,6,3,6,10,3
9,16,3,3,13,16,13,3,3,0
13,16,3,0,6,3,3,0,0,3
3,3,3,3,10,3,0,0,3,10
0,3,23,3,3,3,0,0,0,3
3,6,23,3,6,20,3,0,0,3
23,13,6,3,10,6,0,0,3,10
3,3,0,0,3,0,0,0,0,3
