13,13,6,0,0,3,10,3,3,0
3,6,10,6,0,3,3,6,10,3
0,3,6,20,9,13,6,10,9,0
3,10,3,9,16,16,6,9,10,3
3,6,3,26,16,9,13,13,6,0
13,13,6,16,6,0,3,6,3,0
3,6,3,13,3,0,6,13,13,3
6,23,3,3,3,3,10,9,3,0
13,26,3,3,10,3,6,10,3,0
3,3,0,0,3,0,0,3,0,0
