0,6,10,6,0,0,3,13,6,0
6,10,9,10,3,3,6,16,13,3
13,6,3,3,3,16,13,6,3,3
13,6,10,3,3,13,6,0,6,10
3,0,3,0,3,6,3,3,10,6
3,0,0,3,13,29,13,3,6,0
13,6,0,0,9,16,9,6,13,6
16,13,3,6,13,32,19,16,19,13
3,3,3,20,9,16,16,6,3,3
0,0,0,3,0,3,3,0,0,0
