0,6,10,3,0,3,13,13,3,0
3,10,6,0,0,3,3,6,0,0
0,3,0,0,3,20,6,10,3,3
0,0,0,0,3,3,0,3,3,13
0,0,0,3,10,3,0,3,3,16
0,0,0,0,6,0,6,10,6,13
0,0,3,6,10,6,10,6,0,3
3,3,13,13,6,0,3,3,0,0
10,3,3,3,0,0,3,10,3,0
3,0,0,0,0,0,0,3,0,0
