10,6,0,0,0,3,3,13,3,3
6,10,6,0,3,10,6,13,6,20
0,9,10,3,0,3,0,6,3,3
3,10,6,3,0,3,3,13,26,3
3,3,3,13,6,10,3,6,13,6
23,3,3,13,3,3,0,0,6,10
13,3,0,3,0,0,0,0,3,3
3,0,3,0,0,0,0,3,13,3
0,3,10,3,0,0,0,3,13,3
0,0,3,0,0,0,0,0,3,0
