3,13,13,6,10,3,0,3,0,3
0,3,3,3,6,3,6,10,6,10
0,3,6,13,16,16,16,6,0,3
3,16,16,6,6,9,13,3,0,0
6,19,16,6,26,13,6,0,0,0
16,19,6,3,16,9,3,0,0,3
16,16,3,3,16,19,13,3,3,13
3,6,0,3,6,13,9,0,3,13
3,10,6,10,3,6,10,3,0,3
0,3,0,3,0,0,3,0,0,0
