0,0,3,10,3,3,3,0,0,0
0,0,0,3,6,13,23,3,0,3
0,0,0,3,10,9,6,0,3,10
0,0,0,3,9,16,13,6,0,3
0,3,3,13,19,16,9,20,3,3
3,13,6,6,26,9,0,3,3,10
3,16,13,6,16,16,3,3,3,3
3,3,6,0,9,16,6,13,16,3
10,6,10,6,13,16,3,6,13,3
3,0,3,0,3,3,0,0,3,0
