3,0,0,6,10,6,3,10,3,0
13,3,3,10,9,20,3,3,0,3
33,3,3,3,0,6,0,3,3,10
3,6,10,3,6,20,9,10,3,3
3,10,6,3,13,9,10,9,0,0
0,6,0,3,13,3,9,10,3,0
6,10,3,3,3,3,13,6,3,3
10,6,3,13,3,6,26,6,13,16
3,0,3,13,6,13,16,3,6,13
0,0,0,3,0,3,3,0,0,3
