0,3,10,3,6,13,16,13,3,3
3,0,3,3,13,6,3,3,3,10
10,3,0,3,16,3,0,0,0,3
3,3,0,6,13,3,0,0,0,0
3,13,6,13,6,3,3,0,0,3
6,16,9,26,6,13,13,6,6,10
16,19,16,16,3,6,6,16,16,6
16,6,3,6,3,10,6,26,16,3
13,3,3,20,3,3,0,3,3,0
3,0,0,3,0,0,0,0,0,0
