0,3,26,13,6,10,3,3,10,3
0,3,13,6,0,6,0,0,3,0
0,0,3,3,3,10,3,3,0,3
3,0,3,10,3,3,3,10,9,13
10,3,0,3,0,3,0,6,16,16
6,0,3,0,6,10,3,6,16,6
13,6,13,6,10,6,3,13,26,6
13,9,13,6,3,0,3,6,6,10
6,10,9,10,3,3,13,13,3,3
0,3,0,3,0,0,3,3,0,0
