3,10,3,3,10,3,3,33,3,3
3,3,0,0,3,0,3,13,6,10
13,6,0,0,0,0,3,3,0,6
16,16,3,3,0,3,10,6,3,23
6,33,9,20,3,0,6,10,9,13
0,6,10,6,0,0,0,6,10,6
3,0,6,0,0,0,3,0,3,3
13,6,13,6,0,3,30,3,3,20
13,6,16,13,3,0,3,0,0,3
3,0,3,3,0,0,0,0,0,0
