13,16,13,6,13,3,0,0,0,0
3,3,3,6,13,6,0,0,0,0
0,0,3,23,12,10,3,0,0,3
0,3,6,16,13,6,0,0,3,23
3,23,16,6,3,3,0,3,3,13
0,9,13,3,3,23,6,10,3,3
3,20,9,0,6,13,3,3,0,0
0,6,13,6,10,6,0,0,0,3
0,3,13,3,3,0,0,0,3,10
0,0,3,0,0,0,0,0,0,3
