0,0,3,0,3,13,16,13,3,0
0,6,13,3,0,3,6,3,0,0
3,13,19,6,0,3,10,6,0,0
0,9,26,13,3,0,6,10,3,0
3,13,9,3,0,0,0,3,0,0
3,16,13,3,0,0,0,3,0,0
0,6,3,0,3,3,6,10,3,0
3,10,3,3,16,16,13,9,3,0
0,3,0,3,13,6,6,13,13,3
0,0,0,0,3,0,0,3,3,0
