3,0,3,6,13,6,10,3,0,3
10,6,13,16,16,6,3,0,3,13
3,0,3,6,6,13,3,0,6,16
0,0,6,10,6,13,3,3,13,16
0,3,13,6,3,6,3,0,3,3
0,3,13,9,13,19,13,6,0,0
0,0,6,10,9,16,9,10,6,3
3,3,0,3,6,13,3,9,13,16
13,23,3,3,20,6,3,20,9,13
3,3,0,0,3,0,0,3,0,3
