3,10,9,10,3,3,3,3,13,3
3,9,20,9,6,16,13,6,13,3
16,16,9,16,19,16,6,0,3,0
16,16,6,19,16,6,0,0,0,0
3,3,3,13,6,3,3,0,0,0
0,0,3,3,3,13,13,3,3,0
0,3,20,3,3,3,3,3,23,3
3,3,3,3,10,3,0,3,23,3
13,13,3,0,3,0,0,0,3,0
3,3,0,0,0,0,0,0,0,0
