13,3,3,0,0,3,0,0,3,3
13,6,10,3,3,10,3,3,13,13
3,3,3,3,0,3,0,0,3,6
6,30,9,10,3,0,0,0,6,10
10,12,10,9,0,0,0,6,10,9
6,13,9,20,6,3,3,10,12,10
3,26,6,6,13,13,3,9,10,9
3,19,16,3,3,3,3,10,9,10
3,26,16,3,0,0,0,3,0,3
0,3,3,0,0,0,0,0,0,0
