3,10,6,10,3,0,0,3,0,0
3,6,0,3,3,3,3,10,3,0
13,13,3,6,13,26,3,3,0,0
6,3,6,23,9,16,3,0,0,0
13,6,13,19,6,13,3,0,0,0
13,3,6,16,3,3,0,0,3,0
3,3,3,13,3,3,0,3,13,6
6,10,3,3,3,10,6,6,26,13
10,6,0,0,0,6,23,23,6,3
3,0,0,0,0,0,3,3,0,0
