0,3,13,39,16,23,6,13,13,3
0,0,6,13,6,3,3,3,6,3
0,0,3,3,0,6,13,6,13,23
0,6,13,3,3,26,19,3,3,6
3,13,16,6,3,36,16,6,3,10
0,3,9,13,3,3,9,20,3,3
0,3,16,16,3,3,13,9,0,3
0,6,16,6,3,3,16,26,9,10
3,13,16,6,10,3,6,16,13,6
0,3,3,0,3,0,0,3,3,0
