0,0,0,0,0,6,10,6,10,3
0,0,0,3,3,20,6,0,3,0
0,3,6,13,6,3,3,0,0,3
3,13,16,19,13,6,10,3,6,13
0,3,3,6,3,0,6,3,16,29
3,3,3,13,3,3,10,6,19,16
16,13,9,13,6,0,3,3,13,9
16,12,10,12,20,3,3,3,6,10
16,23,9,10,6,3,13,13,3,3
3,3,0,3,0,0,3,3,0,0
