10,6,13,23,6,0,0,6,10,3
3,3,3,9,10,3,3,13,6,3
6,10,6,10,9,0,3,16,6,10
10,9,0,6,23,3,6,13,3,6
6,10,3,6,13,6,13,6,6,10
3,6,3,10,9,6,13,6,10,6
13,13,6,9,16,13,9,3,3,0
6,9,13,16,16,12,13,13,6,0
13,13,6,3,6,20,6,6,10,3
3,3,0,0,0,3,0,0,3,0
