10,3,3,16,19,26,16,3,0,0
6,0,6,16,29,9,13,3,3,0
10,6,10,9,13,6,6,6,10,3
3,0,3,3,9,26,16,13,6,0
0,0,3,16,16,19,6,3,0,3
3,0,3,13,9,13,6,3,3,13
13,3,0,3,3,6,13,13,6,13
13,3,0,3,10,3,3,3,0,3
3,0,0,0,3,0,0,0,0,0
0,0,0,0,0,0,0,0,0,0
