3,13,13,6,3,13,16,6,10,3
0,3,6,10,3,9,13,6,3,3
0,0,0,3,3,10,9,13,6,10
0,0,3,0,3,3,6,13,3,3
0,3,20,6,13,6,10,6,0,0
0,0,6,6,13,3,6,0,0,3
0,3,13,13,6,3,10,6,3,10
0,0,6,6,0,0,6,13,6,6
0,3,13,13,3,0,3,16,16,13
0,0,3,3,0,0,0,3,3,3
