10,3,6,13,9,13,13,6,0,0
3,6,23,22,13,6,6,10,3,3
6,10,9,13,6,0,3,6,3,13
20,6,3,3,0,3,16,13,6,13
3,6,13,3,0,6,16,6,0,3
3,33,16,3,6,23,19,6,0,3
3,3,3,3,10,9,16,13,6,10
20,6,0,3,3,0,3,3,3,6
6,20,6,10,3,0,0,3,13,13
0,3,0,3,0,0,0,0,3,3
