3,16,13,3,0,3,3,13,6,0
6,13,6,0,3,13,6,16,16,3
10,9,3,0,6,13,3,9,16,3
6,16,26,9,13,6,3,13,16,3
3,19,19,16,19,3,3,6,3,0
3,13,6,9,13,6,26,13,3,0
3,6,3,10,6,6,13,9,3,0
13,16,3,6,3,10,9,16,16,6
6,13,6,10,3,3,3,16,19,13
0,3,0,3,0,0,0,3,3,3
