3,16,23,6,0,3,0,6,20,3
3,16,9,10,6,10,9,10,6,3
6,16,6,3,0,6,13,6,3,10
13,19,16,6,0,3,13,3,0,3
3,9,19,13,3,0,6,0,0,3
6,13,16,6,0,6,13,6,3,10
13,9,3,0,6,13,19,13,6,3
16,13,3,3,13,6,3,9,10,6
3,3,0,3,13,3,3,20,9,20
0,0,0,0,3,0,0,3,0,3
