0,0,0,3,30,6,6,23,13,3
0,0,3,0,6,13,13,6,3,0
0,3,10,3,3,3,3,3,0,0
3,0,3,6,10,6,3,10,6,3
23,3,3,10,9,10,3,6,13,13
13,6,0,6,0,6,0,0,3,3
9,10,9,13,6,10,6,0,0,0
13,12,13,19,3,9,13,3,0,0
26,13,9,13,6,13,16,3,0,0
3,3,0,3,0,3,3,0,0,0
