20,3,0,0,0,0,0,3,0,0
6,0,3,0,3,0,6,10,6,0
10,6,10,9,10,9,13,12,13,6
3,0,6,13,9,23,19,19,19,16
3,0,3,13,3,3,6,13,9,13
10,3,0,6,0,0,0,6,3,3
6,3,6,10,3,0,6,16,16,6
13,16,16,9,0,3,13,22,22,16
3,6,26,13,3,0,6,16,19,16
0,0,3,3,0,0,0,3,3,3
