13,3,0,6,10,6,0,0,0,0
13,3,3,10,9,13,3,0,0,0
3,3,0,3,6,13,3,0,3,0
3,13,6,3,10,6,3,3,13,3
6,16,13,3,3,3,10,6,26,3
13,6,3,3,0,0,3,3,23,3
13,3,3,10,3,0,0,3,6,0
3,3,3,6,3,0,3,16,33,6
3,13,16,16,13,3,3,23,9,10
0,3,3,3,3,0,0,3,0,3
