13,23,3,0,0,3,0,0,0,3
3,6,0,0,3,30,6,0,6,10
3,10,6,3,0,6,10,6,10,6
0,6,16,13,3,0,6,3,3,0
3,3,13,9,0,6,13,23,3,0
10,6,6,13,6,10,9,6,3,3
6,20,6,13,3,9,13,19,16,23
0,3,3,6,3,10,12,23,6,3
0,3,13,13,3,6,10,6,0,0
0,0,3,3,0,0,3,0,0,0
