6,13,13,6,13,9,16,16,3,0
13,9,6,3,19,19,19,19,3,0
19,19,13,6,16,16,9,16,3,3
19,16,6,0,6,6,3,13,6,10
13,6,0,3,16,36,3,3,0,3
3,3,3,3,19,19,6,3,3,0
3,13,16,6,19,22,19,16,16,6
3,6,13,9,16,22,16,12,19,16
10,3,6,10,9,13,9,23,19,26
3,0,0,3,0,3,0,3,3,3
