0,3,0,0,3,0,0,3,10,3
3,10,6,3,13,3,0,3,3,0
0,9,10,6,16,3,6,23,3,0
6,10,6,3,26,6,16,19,3,0
13,6,3,3,13,6,16,19,3,3
13,9,20,6,3,0,6,13,9,10
6,13,9,13,3,0,3,6,10,6
3,13,6,13,3,3,13,3,6,3
0,3,0,3,0,3,13,6,23,13
0,0,0,0,0,0,3,0,3,3
