13,13,9,13,16,3,6,10,3,0
6,6,10,9,26,6,10,6,0,0
10,3,3,3,16,3,6,0,0,0
6,0,3,6,13,6,10,3,3,3
10,9,13,13,9,3,3,3,13,13
6,20,6,6,23,16,3,0,6,3
3,6,3,3,6,13,3,3,10,6
13,19,26,13,3,6,0,0,9,10
6,23,6,3,3,20,3,3,10,6
0,3,0,0,0,3,0,0,3,0
