13,3,3,23,13,9,10,6,10,3
13,3,3,3,6,10,6,0,3,0
3,3,10,6,0,6,0,0,0,0
0,3,9,10,6,13,6,0,0,0
3,23,16,6,6,16,16,3,0,0
0,6,13,6,13,9,16,3,0,0
3,0,3,6,26,6,16,3,3,0
20,3,6,16,16,6,13,6,13,3
3,3,13,26,6,0,3,3,13,3
0,0,3,3,0,0,0,0,3,0
