10,6,23,13,6,6,13,6,10,3
3,0,6,6,16,16,16,6,6,0
3,6,10,6,13,9,6,16,13,3
13,26,9,0,6,10,6,16,9,0
9,16,13,3,0,6,6,26,16,3
10,6,6,0,6,16,26,12,13,3
3,3,13,6,13,19,19,13,6,3
3,3,26,3,6,6,6,6,3,13
10,6,13,6,13,26,16,13,6,13
3,0,3,0,3,3,3,3,0,3
