3,0,3,0,3,10,3,0,3,0
13,6,13,3,3,3,0,3,10,3
13,6,13,6,13,3,3,0,3,3
3,3,6,3,13,6,13,3,6,20
6,13,13,3,3,6,16,9,13,6
13,6,3,0,6,23,19,16,19,3
16,3,0,6,10,6,3,6,13,3
13,3,3,10,6,3,0,0,3,3
3,0,0,3,3,10,3,0,3,10
0,0,0,0,0,3,0,0,0,3
