20,9,10,6,13,16,23,3,0,0
6,10,6,0,3,3,6,0,3,0
0,6,0,0,0,6,20,9,10,3
3,10,6,0,3,10,9,13,6,0
0,6,10,3,3,3,3,16,6,0
0,0,6,6,13,6,6,16,13,3
3,6,13,16,19,16,16,9,3,0
13,16,6,6,3,6,16,23,3,0
6,23,6,10,3,0,3,3,0,0
0,3,0,3,0,0,0,0,0,0
