3,10,3,3,6,16,13,6,13,3
0,3,3,16,26,16,6,3,13,3
0,0,6,13,9,3,0,0,3,3
0,6,10,12,13,3,0,0,6,10
3,10,9,13,19,3,0,6,10,9
3,3,0,6,13,3,6,10,12,10
10,3,0,0,3,3,10,9,10,6
3,3,0,0,3,3,3,0,6,0
3,20,3,3,13,13,3,3,10,3
0,3,0,0,3,3,0,0,3,0
