13,6,13,3,3,13,23,6,13,3
13,6,13,6,0,3,3,3,13,3
3,0,6,10,6,0,0,0,6,0
0,0,0,9,13,3,0,3,10,6
0,0,3,13,16,3,0,3,9,20
0,0,0,3,6,3,3,13,13,6
0,3,0,3,13,13,3,3,3,0
6,13,6,0,3,6,0,0,0,0
13,19,13,3,3,10,3,0,0,0
3,3,3,0,0,3,0,0,0,0
