3,3,16,16,16,16,3,3,0,0
10,6,23,6,6,23,6,10,6,0
3,3,6,0,0,3,0,6,10,6
3,13,16,6,0,3,0,3,6,20
0,6,16,16,6,10,6,20,3,3
0,0,6,13,3,6,3,6,0,0
3,3,3,3,6,13,19,13,3,3
16,26,16,6,10,9,13,6,3,10
13,9,13,3,3,0,3,0,0,3
3,0,3,0,0,0,0,0,0,0
