3,0,6,10,3,6,10,9,13,3
10,6,13,9,3,13,9,13,36,3
3,3,26,23,9,16,6,3,6,0
0,0,3,9,16,19,13,6,13,3
0,0,6,13,26,6,3,3,16,6
0,6,10,6,3,0,0,3,26,13
3,13,6,0,0,0,0,0,3,6
3,16,3,0,3,0,3,0,6,20
3,13,3,3,20,6,10,6,10,6
0,3,0,0,3,0,3,0,3,0
