0,0,0,0,0,3,0,0,0,3
0,0,0,0,3,10,3,3,6,23
3,3,0,0,0,3,6,13,16,19
13,23,6,0,0,3,10,6,6,13
3,9,10,3,0,0,6,0,3,3
3,10,9,0,0,6,10,6,13,3
3,9,13,3,3,23,6,3,16,3
13,29,16,3,3,16,6,3,13,6
6,13,6,0,3,16,13,3,6,10
0,3,0,0,0,3,3,0,0,3
