13,19,13,6,16,13,9,10,3,0
9,13,6,3,13,9,10,6,3,3
10,6,3,0,6,0,3,3,13,13
3,3,10,6,10,3,0,0,3,3
0,3,6,3,3,0,0,3,0,0
3,16,16,13,6,3,3,10,3,0
6,23,6,6,13,23,6,6,0,0
10,9,0,0,3,6,16,13,3,3
6,20,3,0,0,3,13,6,3,10
0,3,0,0,0,0,3,0,0,3
