0,3,13,3,3,3,23,16,13,3
0,6,13,6,13,3,6,3,6,3
3,10,9,6,16,6,10,9,23,13
0,6,13,19,16,3,6,10,6,3
0,0,6,36,6,0,0,3,0,0
0,3,3,16,3,3,3,3,3,0
3,13,6,23,6,13,19,16,26,3
3,13,3,3,0,6,16,9,13,6
0,3,0,0,0,3,13,3,6,10
0,0,0,0,0,0,3,0,0,3
