10,6,20,6,3,3,3,13,3,0
3,3,6,13,19,23,6,13,3,3
3,20,6,6,16,6,0,3,6,10
0,6,13,6,13,3,0,3,10,6
0,3,13,3,6,0,0,0,6,0
0,3,3,3,13,3,0,3,10,3
3,10,6,3,13,6,0,0,6,3
3,6,13,6,9,13,3,3,13,16
10,6,16,26,16,16,3,0,6,13
3,0,3,3,3,3,0,0,0,3
