13,13,3,0,3,23,3,3,0,3
3,6,0,0,6,13,9,10,6,10
6,10,6,3,10,12,13,9,0,6
13,12,10,3,6,23,19,13,6,10
19,13,6,3,0,3,3,3,0,3
13,6,6,10,3,3,0,0,0,3
3,3,13,9,6,20,3,0,6,10
0,6,19,26,16,9,3,3,10,9
3,13,16,9,16,16,13,3,6,10
0,3,3,0,3,3,3,0,0,3
