0,3,6,33,16,3,0,0,0,0
3,13,13,9,13,6,0,0,0,0
0,3,6,3,6,20,3,3,0,0
0,6,26,13,3,3,3,13,3,0
6,16,16,6,0,0,3,13,3,3
23,16,6,3,0,0,0,3,3,13
3,3,3,20,3,3,0,0,6,13
0,0,3,6,3,10,3,6,10,9
0,3,13,13,3,3,3,20,9,20
0,0,3,3,0,0,0,3,0,3
