6,10,3,0,3,0,0,0,0,0
10,6,0,6,13,3,3,0,3,0
3,3,3,16,16,6,10,6,13,6
6,23,6,26,6,0,6,3,19,23
13,26,6,26,6,3,10,6,13,9
3,3,3,16,13,3,3,0,6,13
3,3,0,3,3,0,3,3,6,13
23,16,3,0,3,3,16,16,23,6
6,23,3,3,10,6,13,6,3,0
0,3,0,0,3,0,3,0,0,0
