3,6,10,3,0,0,3,6,20,3
13,13,9,0,0,3,16,13,9,0
3,6,10,3,3,3,13,9,10,3
0,0,3,3,13,6,6,0,3,0
0,0,0,6,19,19,16,3,0,0
0,0,3,16,19,19,16,6,0,0
0,0,3,13,6,3,6,10,3,3
0,0,0,3,0,0,0,6,6,10
0,0,0,0,0,0,3,13,13,6
0,0,0,0,0,0,0,3,3,0
