6,10,6,3,3,0,0,6,10,3
10,9,13,16,23,3,3,10,6,0
3,3,6,6,6,0,3,3,0,0
3,13,16,19,16,6,20,3,0,3
0,3,6,19,16,3,3,0,6,10
0,0,3,16,9,0,0,3,10,6
3,0,3,29,13,3,0,0,3,0
10,6,3,36,6,3,3,0,0,0
6,10,6,13,6,13,13,3,0,0
0,3,0,3,0,3,3,0,0,0
