6,10,3,6,16,16,16,3,0,3
13,6,3,16,16,12,16,3,6,13
13,3,6,13,12,13,16,6,13,16
3,3,13,9,10,6,3,0,6,3
0,6,16,3,3,0,3,3,10,3
3,16,19,3,0,3,10,3,6,0
3,19,16,3,0,0,3,6,10,3
3,16,9,0,0,3,6,10,6,0
3,16,13,3,3,23,13,6,0,0
0,3,3,0,0,3,3,0,0,0
