0,3,0,3,13,6,0,0,0,0
6,13,3,3,16,13,3,0,0,0
13,19,6,0,3,6,0,0,0,0
6,16,26,6,3,10,3,0,0,0
0,6,26,13,3,3,0,3,0,3
3,3,3,3,3,0,3,10,6,10
16,13,6,3,13,3,0,3,3,3
13,9,13,6,23,3,0,3,10,3
3,3,13,3,3,0,0,0,3,0
0,0,3,0,0,0,0,0,0,0
