3,0,0,3,10,3,0,3,0,0
13,3,0,0,6,0,3,10,3,3
16,3,0,3,13,3,0,3,3,13
13,6,0,3,13,6,0,3,6,13
6,10,6,0,6,10,6,13,23,9
0,6,10,6,3,3,0,3,9,13
0,3,6,13,23,3,0,3,16,16
3,23,3,3,3,0,3,3,13,6
3,13,3,0,0,3,10,3,3,0
0,3,0,0,0,0,3,0,0,0
