3,0,3,10,3,3,10,6,10,3
10,3,0,3,0,0,6,0,3,0
3,0,0,3,0,6,10,3,0,3
3,0,3,13,6,30,6,3,6,20
10,3,3,23,6,3,3,13,13,6
3,0,3,6,10,3,3,3,6,3
0,6,13,3,3,3,20,9,13,13
3,13,26,3,0,3,9,10,6,6
0,3,3,0,3,23,13,6,3,10
0,0,0,0,0,3,3,0,0,3
