3,13,6,0,3,3,10,3,3,0
3,26,13,9,13,6,3,3,10,3
3,3,9,13,29,13,6,0,3,0
13,6,10,6,3,6,10,6,0,0
13,3,3,0,3,3,9,10,6,0
3,0,0,3,13,16,13,9,10,3
0,0,0,3,6,3,3,0,6,3
0,3,6,16,16,3,3,3,16,13
3,13,16,19,26,6,10,6,13,6
0,3,3,3,3,0,3,0,3,0
