0,3,0,0,0,0,6,13,16,3
3,13,6,3,3,3,10,9,13,3
3,16,16,16,13,3,3,0,3,0
3,3,6,6,3,3,0,0,3,0
10,6,13,13,6,10,3,3,10,6
6,3,6,3,0,6,3,3,9,20
16,16,23,3,3,13,16,26,13,6
13,6,3,0,0,6,3,3,6,0
3,0,0,0,3,10,3,3,10,3
0,0,0,0,0,3,0,0,3,0
