13,3,6,10,3,0,0,3,10,3
13,9,10,9,0,0,0,0,3,3
9,13,12,20,3,3,3,0,3,10
13,22,13,6,3,16,13,3,0,3
6,13,6,3,3,13,6,0,0,0
3,3,3,30,3,3,0,0,3,0
10,3,0,6,0,0,3,3,10,3
3,0,6,13,3,6,13,3,3,3
0,3,13,16,6,13,16,3,3,10
0,0,3,3,0,3,3,0,0,3
