20,3,3,10,6,10,9,10,6,0
3,3,3,6,0,6,10,9,13,3
3,13,19,13,3,0,6,6,13,3
0,6,13,9,3,3,13,13,6,0
3,3,6,13,26,3,3,3,0,3
13,23,3,6,23,3,3,0,3,23
3,3,0,3,3,3,13,6,6,13
0,3,3,10,6,3,16,19,26,6
3,30,3,6,10,3,6,26,16,3
0,3,0,0,3,0,0,3,3,0
