0,0,0,0,0,0,6,26,13,3
0,3,0,0,0,6,16,16,6,3
3,13,6,0,3,13,16,6,3,13
3,16,13,3,3,3,6,0,3,16
3,3,6,3,10,6,10,3,6,13
10,6,10,3,3,3,3,6,10,6
6,0,3,3,6,13,6,13,6,0
10,3,3,13,16,16,6,13,3,0
3,0,0,3,3,3,0,3,0,0
0,0,0,0,0,0,0,0,0,0
