3,0,3,13,6,10,9,20,3,0
13,3,3,13,3,6,10,9,0,0
13,3,0,3,0,0,9,10,3,3
6,0,0,0,0,3,10,9,3,10
10,6,3,3,3,0,9,10,3,6
6,13,16,16,16,6,13,6,6,10
0,3,3,9,13,6,13,6,10,9
3,0,3,13,6,3,3,3,6,20
10,3,3,13,6,10,6,10,3,3
3,0,0,3,0,3,0,3,0,0
