13,3,3,13,16,3,0,3,0,0
16,6,0,9,13,3,6,10,3,3
16,16,9,10,6,3,10,6,6,10
9,19,13,9,0,0,3,3,10,6
13,16,9,20,6,0,0,0,3,0
3,6,0,6,10,6,0,0,3,3
3,10,3,0,6,13,3,6,13,16
3,3,0,0,3,13,6,10,12,23
20,3,0,0,0,3,0,6,10,6
3,0,0,0,0,0,0,0,3,0
