0,0,0,3,0,6,13,3,0,3
0,0,3,10,6,13,19,3,3,13
0,3,0,6,0,6,13,3,3,16
3,13,6,10,3,0,3,0,3,16
3,13,3,3,0,3,0,3,6,23
0,3,0,3,3,10,9,13,16,9
3,0,6,10,3,6,10,9,26,13
13,6,13,9,0,3,3,0,3,6
13,6,16,13,6,10,3,0,3,10
3,0,3,3,0,3,0,0,0,3
