13,19,13,3,0,0,0,0,0,3
9,16,6,0,0,0,0,0,6,13
16,16,6,0,0,0,0,3,23,16
13,12,10,6,3,0,3,3,3,6
9,13,9,13,13,6,16,16,6,10
23,16,3,3,6,3,26,16,6,3
6,3,3,3,10,3,3,9,20,3
13,6,10,6,3,3,3,13,6,0
13,3,6,10,6,10,6,13,3,0
3,0,0,3,0,3,0,3,0,0
