6,10,6,0,3,0,0,0,0,0
10,9,10,6,13,3,0,0,3,0
3,3,3,3,16,3,0,3,10,6
3,10,3,6,13,6,0,0,6,10
0,6,6,20,9,10,3,0,0,3
3,16,13,6,0,6,3,0,3,0
6,16,9,0,3,13,13,6,13,3
13,29,13,3,0,3,6,3,13,6
3,3,3,0,0,3,10,3,6,10
0,0,0,0,0,0,3,0,0,3
