0,3,0,0,3,23,3,0,0,0
6,23,6,3,6,13,3,0,3,0
23,19,19,26,13,6,3,3,13,3
6,9,16,6,3,3,10,9,13,3
23,26,26,3,0,3,6,10,6,3
3,6,6,0,3,10,3,3,3,10
6,13,16,3,3,3,0,0,0,3
13,9,33,6,13,3,0,0,0,0
13,3,3,3,13,3,0,0,0,0
3,0,0,0,3,0,0,0,0,0
