0,3,6,13,6,10,3,0,3,0
6,26,16,16,3,3,0,3,10,3
13,19,6,6,3,3,3,3,3,0
9,16,6,13,16,19,26,23,3,3
13,16,3,6,9,16,9,3,6,13
3,3,3,13,16,19,23,6,13,16
0,3,0,3,6,3,3,0,3,3
3,10,6,6,10,3,3,0,3,0
0,6,23,13,6,3,10,6,20,3
0,0,3,3,0,0,3,0,3,0
