0,3,13,3,6,10,6,16,23,3
0,3,16,6,20,9,6,23,6,0
0,3,23,6,6,13,16,9,0,0
0,3,6,13,3,6,19,16,3,0
3,10,6,16,6,3,19,16,3,3
0,3,3,19,16,6,13,9,3,10
0,0,3,16,16,3,9,10,6,3
0,0,0,3,6,3,10,12,20,3
0,0,0,3,20,3,6,10,6,0
0,0,0,0,3,0,0,3,0,0
