10,6,3,10,6,3,10,3,3,0
6,13,3,6,10,6,3,6,23,3
3,13,3,0,9,10,9,16,16,3
0,6,3,3,10,9,26,16,6,3
3,13,16,3,3,3,26,6,6,10
0,6,16,3,0,3,13,6,13,6
0,3,13,3,0,3,3,3,13,3
3,0,6,3,3,20,3,0,3,0
10,6,13,13,3,3,0,0,0,0
3,0,3,3,0,0,0,0,0,0
