10,6,13,13,6,13,26,13,6,0
3,3,3,3,0,6,6,9,13,3
3,10,3,3,3,16,16,16,26,3
3,3,3,13,9,13,6,6,6,3
10,3,3,19,13,9,3,13,16,13
3,0,6,13,9,10,6,3,3,3
0,6,10,6,3,6,10,3,0,0
3,10,9,3,30,3,3,0,0,0
0,6,20,3,3,0,0,0,0,0
0,0,3,0,0,0,0,0,0,0
