23,23,9,10,6,3,10,3,0,0
6,9,10,9,10,3,3,0,3,0
13,23,6,3,3,3,0,3,13,3
3,3,6,20,6,10,3,6,23,3
0,3,13,6,0,6,3,10,6,3
0,3,16,3,3,13,6,6,3,10
0,3,13,6,6,16,19,16,6,3
0,3,6,16,13,12,29,29,13,3
3,10,6,13,9,13,16,6,3,0
0,3,0,3,0,3,3,0,0,0
