10,3,3,0,3,13,9,10,3,3
3,3,13,6,6,16,23,9,3,10
3,6,16,19,13,6,6,10,3,6
33,16,9,16,9,0,0,3,6,13
9,13,6,16,13,3,0,3,16,19
10,6,0,6,3,0,0,6,26,16
3,3,3,13,3,0,3,10,6,6
6,10,6,16,3,3,3,3,3,10
20,6,3,13,6,13,13,3,0,3
3,0,0,3,0,3,3,0,0,0
