3,3,3,3,3,0,3,10,3,0
23,16,19,16,13,6,0,6,3,3
6,6,13,6,6,10,6,16,16,13
10,3,3,0,0,6,3,13,6,6
3,0,0,0,3,10,6,3,3,13
0,0,0,0,3,6,10,6,3,23
0,0,0,3,13,6,6,20,6,6
0,0,0,6,19,23,6,6,16,13
0,0,3,23,16,9,10,6,13,6
0,0,0,3,3,0,3,0,3,0
