3,0,3,0,0,3,10,6,13,3
13,6,10,3,3,0,6,6,16,3
13,6,3,3,20,6,16,16,26,3
6,10,6,0,3,3,23,6,3,0
0,6,10,6,0,0,3,3,3,3
3,3,9,10,3,0,6,16,16,16
13,16,13,6,0,3,13,19,9,23
3,6,3,0,0,0,6,13,3,3
3,10,3,0,0,0,0,3,0,0
0,3,0,0,0,0,0,0,0,0
