3,3,0,0,6,13,3,0,0,3
13,13,3,3,13,16,6,0,6,13
6,3,0,0,6,6,10,6,26,19
13,6,3,3,10,3,3,3,19,16
19,16,13,3,3,0,3,3,13,6
13,6,3,3,3,3,10,3,6,3
3,0,6,13,16,6,6,3,16,13
0,3,13,9,16,19,16,6,13,6
0,3,13,3,6,16,16,3,3,0
0,0,3,0,0,3,3,0,0,0
