0,0,3,16,16,6,13,6,3,0
0,0,3,16,16,6,16,19,13,3
0,3,0,3,6,0,9,16,6,0
6,20,6,6,10,6,13,16,6,0
30,9,13,13,6,0,3,6,10,3
3,0,6,3,0,0,0,0,3,3
0,6,13,3,0,3,3,0,3,10
6,16,16,3,3,16,13,3,3,6
13,16,6,0,3,13,6,3,13,13
3,3,0,0,0,3,0,0,3,3
