16,16,3,0,6,10,9,10,3,0
26,16,3,6,10,12,10,9,0,3
3,6,3,10,9,13,9,10,6,10
3,23,3,6,3,13,3,6,0,6
6,16,6,23,3,3,3,20,6,10
13,16,6,13,3,0,3,3,3,3
3,6,3,3,3,3,10,6,13,3
6,23,16,9,13,3,6,3,23,3
10,9,16,16,16,6,10,3,3,0
3,0,3,3,3,0,3,0,0,0
