13,16,16,6,26,29,16,16,3,0
3,9,16,6,19,16,9,13,6,0
3,23,16,9,13,6,0,6,10,3
3,3,6,10,9,3,0,3,6,0
13,3,0,6,26,13,6,13,13,3
16,3,3,6,16,9,0,6,3,3
13,9,13,16,22,13,9,23,6,13
6,13,9,6,23,9,16,16,6,16
3,16,13,3,3,3,13,6,3,13
0,3,3,0,0,0,3,0,0,3
