0,3,3,0,3,6,10,3,0,0
3,13,16,6,16,13,6,0,3,0
0,6,16,6,13,6,0,3,10,3
3,3,26,6,3,3,0,0,3,3
10,6,16,13,6,10,3,3,3,10
3,3,3,3,0,3,3,13,3,3
3,10,6,0,3,0,3,23,6,0
3,9,13,6,10,6,0,6,23,3
23,16,16,3,6,10,3,3,13,3
3,3,3,0,0,3,0,0,3,0
