13,19,16,13,3,0,6,13,6,0
6,13,9,6,3,3,23,22,13,3
3,6,16,19,16,3,6,23,6,0
10,9,19,19,16,3,3,3,0,0
6,26,16,9,3,6,20,3,3,0
3,13,9,10,6,10,6,3,10,3
3,3,0,6,0,6,0,0,3,0
10,3,6,10,9,20,6,0,0,0
3,3,10,9,10,9,20,3,0,0
0,0,3,0,3,0,3,0,0,0
