3,3,10,9,13,6,23,3,0,0
20,6,6,23,16,6,13,3,3,0
9,20,3,3,6,0,6,3,10,3
13,9,0,3,13,6,10,3,3,0
16,13,6,3,13,3,3,0,0,0
3,6,13,3,6,0,3,0,0,0
0,3,13,9,10,6,13,3,0,3
0,0,6,10,9,6,13,3,3,10
0,0,0,6,13,13,6,0,0,3
0,0,0,0,3,3,0,0,0,0
