13,3,3,0,6,10,3,6,10,3
16,6,10,6,10,9,3,13,6,0
23,3,6,0,9,10,6,13,3,3
3,6,10,6,23,9,0,3,3,10
3,33,6,3,19,13,3,0,0,3
3,13,6,6,16,6,0,0,3,0
0,6,16,19,16,6,0,3,10,3
0,3,16,19,9,13,3,3,3,3
0,0,6,13,6,13,6,10,6,10
0,0,0,3,0,3,0,3,0,3
