3,10,3,0,3,23,6,13,26,3
3,3,0,0,3,13,6,6,13,3
20,3,0,0,3,9,10,3,3,0
3,0,3,3,13,16,9,3,0,0
3,3,20,3,9,19,16,13,6,0
10,3,3,3,26,16,6,6,10,3
3,3,3,6,13,9,0,0,3,0
3,13,16,13,9,10,3,3,0,3
0,3,3,3,0,3,3,10,6,20
0,0,0,0,0,0,0,3,0,3
