0,0,3,10,6,3,0,0,0,0
0,0,3,6,13,16,3,0,0,3
3,3,10,6,6,13,3,0,3,10
20,3,9,13,3,3,0,3,0,3
3,3,26,26,3,3,6,10,3,0
0,6,16,9,3,16,13,6,0,0
3,16,19,16,9,13,6,3,0,3
3,13,9,16,13,6,6,10,9,10
0,3,0,3,3,3,10,9,10,6
0,0,0,0,0,0,3,0,3,0
