3,10,3,3,10,3,0,0,0,0
0,3,0,0,6,0,0,0,3,0
0,0,0,6,10,3,0,3,10,6
3,0,3,13,6,0,0,0,6,13
20,3,3,16,3,3,0,0,3,16
6,3,3,16,6,10,3,0,3,16
13,16,6,13,6,3,0,3,3,16
6,16,3,9,10,3,3,20,6,13
3,13,6,10,6,0,0,3,0,3
0,3,0,3,0,0,0,0,0,0
