0,0,3,13,6,0,0,0,0,3
0,0,3,16,13,3,0,0,3,10
0,0,0,3,6,0,3,0,0,3
0,0,0,3,10,6,10,6,0,3
3,0,3,0,3,0,6,10,9,20
10,9,13,3,0,0,0,6,13,6
6,26,16,6,3,0,0,3,13,3
3,13,9,13,16,3,3,3,6,3
0,3,0,6,13,6,13,16,16,13
0,0,0,0,3,0,3,3,3,3
