3,0,0,3,0,0,6,10,3,3
10,6,3,10,3,3,10,9,3,30
9,10,3,3,0,0,6,10,3,3
10,6,0,3,0,3,0,3,0,0
6,0,6,10,6,10,3,0,0,0
23,6,10,9,0,3,3,3,0,3
13,3,6,10,6,3,13,13,6,13
6,0,3,9,10,3,6,3,3,13
10,6,13,13,6,3,10,3,0,3
3,0,3,3,0,0,3,0,0,0
