3,0,0,0,0,0,0,0,3,0
13,3,3,0,3,0,0,3,13,3
13,6,13,6,10,3,3,3,13,3
6,3,23,3,6,6,13,3,3,0
10,3,3,3,26,16,16,6,0,3
3,0,0,3,13,6,9,10,6,10
0,3,0,0,6,3,20,9,0,6
6,13,3,6,13,3,6,10,9,10
13,26,6,23,16,3,0,6,10,6
3,3,0,3,3,0,0,0,3,0
