13,3,3,10,6,13,16,16,16,3
16,3,3,6,0,6,3,6,13,3
13,6,23,23,6,10,6,3,3,0
6,0,3,6,3,6,13,13,3,0
10,3,3,13,23,6,3,6,0,0
3,3,3,3,6,10,6,13,3,0
3,16,13,6,0,6,6,13,3,0
3,13,12,10,6,16,13,6,3,0
0,6,10,6,3,23,6,3,10,3
0,0,3,0,0,3,0,0,3,0
