3,20,6,13,6,6,10,3,0,0
3,3,3,16,16,16,6,0,3,3
10,3,0,3,6,13,3,3,16,13
3,3,0,0,3,3,0,3,16,6
3,13,3,3,13,3,3,3,23,3
3,13,3,6,13,6,13,3,6,3
0,6,3,13,6,3,13,9,16,23
3,10,6,13,3,3,6,13,16,6
0,3,0,3,3,10,3,3,3,0
0,0,0,0,0,3,0,0,0,0
