20,3,3,13,9,10,3,0,0,3
6,3,3,16,13,6,3,0,3,13
13,16,3,3,3,3,13,3,3,13
6,16,3,0,0,3,23,6,0,3
3,16,3,3,3,3,9,10,6,0
3,16,6,13,39,16,16,12,13,3
6,13,3,6,16,9,16,16,26,6
10,6,0,3,16,3,6,3,6,10
3,0,0,3,13,6,10,3,0,3
0,0,0,0,3,0,3,0,0,0
