0,3,3,13,33,6,13,16,13,3
3,20,3,3,3,0,3,3,3,0
0,3,3,0,0,3,0,0,0,3
3,6,10,3,3,10,3,0,6,10
13,13,6,0,3,6,0,3,13,6
3,3,3,3,13,13,3,6,13,6
0,3,13,6,6,3,3,20,9,10
0,3,16,19,13,6,3,6,3,3
0,0,6,13,9,13,16,16,23,3
0,0,0,3,0,3,3,3,3,0
