6,10,6,3,10,3,0,3,3,3
13,9,10,3,3,3,3,16,16,13
23,6,3,0,6,20,6,13,6,3
6,10,3,6,10,9,3,6,3,3
0,3,3,13,9,13,19,16,26,13
0,0,3,26,3,6,16,9,3,3
0,0,3,23,3,3,19,13,3,0
0,0,3,3,0,3,13,6,0,0
0,3,10,3,0,0,3,0,0,0
0,0,3,0,0,0,0,0,0,0
