23,16,19,13,9,13,19,13,3,0
3,9,16,9,10,9,13,6,0,0
3,16,19,6,3,0,3,0,0,0
3,16,22,13,3,0,3,3,3,0
0,6,23,9,0,3,13,16,16,3
0,0,9,20,3,0,6,6,16,3
0,3,10,9,3,6,10,9,13,3
3,3,9,16,16,13,9,10,6,0
13,16,16,16,6,3,0,3,0,0
3,3,3,3,0,0,0,0,0,0
