3,0,0,3,0,3,0,0,0,0
10,3,3,20,6,10,3,0,3,0
3,0,3,6,0,3,0,6,10,3
0,3,13,13,6,0,3,10,9,0
0,3,3,6,20,3,0,9,10,3
3,10,6,0,3,0,3,10,9,0
3,6,10,3,0,0,3,6,10,3
13,6,6,0,0,6,10,3,3,3
26,16,23,3,3,10,6,0,3,10
3,3,3,0,0,3,0,0,0,3
