13,13,9,13,3,3,10,6,10,3
6,6,13,16,3,0,3,0,3,3
10,6,3,3,0,0,0,0,3,13
9,10,3,0,0,0,3,0,3,13
13,6,0,3,0,6,10,3,0,3
13,3,6,10,6,13,6,0,0,0
6,3,20,6,3,13,3,0,0,3
10,6,6,0,3,3,3,3,3,10
6,13,13,6,10,6,23,13,3,3
0,3,3,0,3,0,3,3,0,0
