16,16,3,0,0,0,3,13,13,3
16,16,3,3,0,0,0,3,3,3
6,3,3,30,6,0,0,3,3,10
10,3,0,6,10,3,3,13,3,6
3,3,0,0,6,0,3,16,6,10
3,10,3,3,13,6,6,23,6,6
3,3,3,3,16,16,26,9,16,13
20,6,10,3,6,6,13,6,13,6
3,0,3,3,10,3,3,0,3,0
0,0,0,0,3,0,0,0,0,0
