10,3,0,0,0,0,3,0,0,0
3,0,0,0,0,3,10,6,0,0
0,0,3,0,0,0,6,10,3,3
3,3,13,3,0,0,3,6,3,10
10,9,33,3,0,3,13,13,3,6
9,10,6,0,0,0,3,3,3,13
10,6,0,3,0,0,3,0,6,13
3,0,6,13,6,6,13,9,10,6
0,3,13,19,16,16,19,13,6,0
0,0,3,3,3,3,3,3,0,0
