23,6,0,6,13,3,3,6,20,3
19,13,9,13,19,6,13,16,9,0
13,9,10,12,16,3,6,19,13,3
3,3,6,23,16,6,3,13,6,3
6,10,3,6,9,10,3,3,3,10
20,6,3,26,16,6,0,0,3,6
3,0,3,26,19,3,0,3,16,16
0,0,0,9,13,6,3,3,16,26
0,0,3,10,9,23,13,3,3,3
0,0,0,3,0,3,3,0,0,0
