3,0,3,13,16,26,3,0,0,0
13,3,3,3,6,23,3,0,0,0
36,9,13,6,0,3,3,0,0,0
16,19,22,16,3,3,10,3,0,0
9,16,19,29,3,0,6,3,0,3
13,6,6,16,6,3,13,26,9,10
13,3,3,29,13,3,9,19,23,6
3,0,3,13,6,3,16,19,6,3
0,0,0,3,0,3,16,26,6,10
0,0,0,0,0,0,3,3,0,3
