0,3,6,13,13,6,23,16,3,0
3,23,23,6,6,0,6,13,6,0
0,3,3,6,13,3,3,6,10,3
3,0,3,13,19,6,10,6,3,3
10,6,0,6,23,3,9,10,6,10
6,10,6,3,3,3,10,6,0,6
0,9,13,13,3,3,3,0,6,10
3,20,6,3,3,10,3,6,10,6
0,3,0,0,0,3,3,10,6,0
0,0,0,0,0,0,0,3,0,0
