0,0,0,6,10,3,3,13,6,0
0,3,6,13,6,0,3,16,13,3
3,13,16,16,6,3,0,3,6,0
0,3,3,6,13,13,3,6,10,6
3,0,0,3,3,3,6,10,12,10
10,3,3,10,6,3,10,9,10,6
6,0,0,9,13,6,3,3,3,0
10,3,6,13,19,13,9,10,3,0
3,3,10,6,3,6,10,6,0,0
0,0,3,0,0,0,3,0,0,0
