3,13,3,0,3,10,6,0,3,0
6,13,6,0,3,6,13,6,13,6
10,9,13,6,13,6,13,6,29,16
6,3,13,6,13,3,3,3,19,16
10,3,3,3,3,0,0,3,13,6
3,0,3,13,3,0,3,0,3,3
0,0,3,13,3,6,10,3,6,10
0,3,3,3,3,10,6,3,13,6
3,13,23,3,0,3,0,3,13,3
0,3,3,0,0,0,0,0,3,0
