0,0,0,6,13,13,3,3,0,3
0,3,3,10,6,3,6,23,6,10
3,13,3,6,0,3,23,26,6,3
3,16,6,23,3,0,6,6,13,3
6,13,9,16,3,6,20,6,13,3
10,9,16,26,9,10,9,0,3,0
3,6,13,9,10,9,10,3,3,0
6,10,6,0,6,3,6,3,10,3
10,6,0,3,13,16,13,3,3,0
3,0,0,0,3,3,3,0,0,0
