0,0,0,3,0,0,3,10,6,0
0,0,3,10,6,3,0,6,10,3
0,0,0,6,16,13,3,0,6,0
0,0,0,6,23,6,0,6,13,6
0,3,6,13,6,0,3,13,22,13
3,13,16,29,6,3,0,9,16,6
0,3,9,16,19,13,9,13,36,3
0,6,10,9,13,9,10,6,6,0
3,10,6,0,3,0,3,3,10,3
0,3,0,0,0,0,0,0,3,0
