3,3,13,13,6,3,10,3,3,0
10,6,3,9,13,3,6,6,13,3
9,30,9,13,16,9,23,16,16,3
10,12,13,6,6,10,9,3,6,0
9,13,16,3,0,6,10,9,10,3
10,9,6,3,3,3,6,10,6,3
6,13,16,16,16,13,3,3,6,10
0,3,3,3,3,3,3,3,10,9
0,0,0,0,0,3,10,3,6,20
0,0,0,0,0,0,3,0,0,3
