3,3,3,10,6,3,20,3,0,0
26,13,3,6,13,3,6,0,0,0
13,6,3,6,13,9,10,6,0,3
3,3,33,16,9,13,12,10,6,10
0,0,6,16,9,16,13,6,3,3
0,0,6,16,13,6,3,3,10,6
3,6,13,9,6,0,0,3,6,13
16,16,32,16,16,3,6,10,9,13
13,9,13,9,13,6,10,9,20,6
3,0,3,0,3,0,3,0,3,0
