0,6,13,16,6,10,3,3,10,3
6,20,9,13,6,3,0,0,3,0
10,9,0,6,13,3,0,0,0,0
6,20,3,3,23,6,0,0,0,3
0,3,0,3,6,20,6,0,6,10
0,0,3,10,3,6,10,6,10,6
0,0,0,3,0,0,3,0,3,0
0,0,3,0,0,0,0,0,0,0
0,3,10,3,0,0,0,0,0,0
0,0,3,0,0,0,0,0,0,0
