10,9,13,13,6,3,3,13,3,0
6,10,6,6,13,13,6,23,3,0
0,6,0,3,6,3,0,6,0,0
3,10,6,13,23,3,3,10,3,3
3,3,3,3,3,0,0,3,6,10
13,6,10,6,0,0,3,3,13,9
16,6,9,10,3,6,13,9,26,13
16,19,16,9,3,16,22,16,6,3
6,16,19,13,6,16,19,16,3,0
0,3,3,3,0,3,3,3,0,0
