6,16,16,13,3,0,0,3,13,3
13,19,6,3,3,0,0,6,16,3
9,13,3,6,10,6,3,13,16,3
23,9,3,10,9,10,6,3,3,3
29,13,6,3,0,9,13,3,3,13
13,9,10,3,6,16,19,3,6,13
6,0,3,3,13,22,19,6,10,9
13,3,0,0,6,16,16,3,6,20
13,3,0,0,0,3,3,0,0,3
3,0,0,0,0,0,0,0,0,0
