3,0,0,0,0,0,0,3,10,3
10,3,0,3,0,0,0,0,3,3
6,3,3,13,3,3,3,0,3,10
13,13,6,13,9,13,16,3,0,3
6,6,0,6,20,9,13,3,0,0
13,13,3,3,3,0,3,0,0,3
3,3,3,13,6,3,0,0,3,20
3,0,3,16,16,23,3,0,0,6
20,3,0,3,3,3,0,0,3,10
3,0,0,0,0,0,0,0,0,3
