0,0,3,10,6,0,0,0,0,3
0,0,0,6,20,6,0,0,6,33
0,0,0,0,6,10,3,3,13,19
3,3,3,0,3,3,0,0,9,13
16,16,13,6,13,3,3,6,10,6
13,6,3,6,23,6,13,13,9,0
3,0,3,13,9,3,3,9,13,6
0,3,6,16,19,13,9,13,22,13
3,23,13,9,13,9,10,9,13,6
0,3,3,0,3,0,3,0,3,0
