13,6,13,23,3,0,0,3,3,3
13,3,3,3,3,0,3,26,19,13
3,0,0,3,23,3,6,16,16,6
0,3,0,6,13,6,10,9,3,0
3,13,9,10,9,0,6,13,3,0
6,19,13,12,20,3,3,16,3,0
13,16,12,10,9,0,3,13,6,3
6,6,13,9,10,6,0,6,13,13
10,6,23,3,6,10,3,0,3,3
3,0,3,0,0,3,0,0,0,0
