13,13,9,10,6,10,3,0,0,0
3,6,10,9,3,6,0,3,3,0
3,0,6,16,16,13,9,13,16,3
20,3,3,13,9,6,20,9,16,3
6,0,3,6,23,3,3,6,16,3
23,6,13,6,13,3,3,13,16,3
16,9,13,6,3,0,0,6,3,0
19,13,9,10,3,3,6,13,3,3
23,6,0,3,3,13,16,16,6,20
3,0,0,0,0,3,3,3,0,3
