0,6,13,13,3,0,0,0,3,0
3,13,6,3,3,0,0,6,10,3
6,13,3,3,10,3,3,13,9,3
13,6,0,0,3,3,6,19,16,16
16,6,0,0,3,13,36,16,9,13
16,16,3,3,0,3,6,6,0,3
6,13,6,10,3,3,16,13,3,3
3,3,0,3,3,3,13,9,6,10
10,3,0,3,10,3,6,13,13,6
3,0,0,0,3,0,0,3,3,0
