13,3,0,3,3,3,3,10,3,3
13,3,3,13,29,16,3,3,6,10
3,3,0,6,19,19,3,6,10,6
6,10,3,6,26,19,6,20,6,0
13,9,3,10,9,23,3,6,3,0
19,13,6,3,0,3,3,13,13,3
13,9,10,3,3,0,0,3,3,0
3,0,6,6,23,6,0,0,3,0
0,3,13,16,19,13,3,3,10,3
0,0,3,3,3,3,0,0,3,0
