13,13,6,0,0,3,0,3,30,3
3,6,13,3,3,10,3,3,3,0
3,3,13,3,0,3,6,10,6,0
13,3,3,0,0,3,10,12,23,3
13,6,0,0,0,3,6,16,26,3
6,13,3,3,3,10,9,16,9,0
3,13,6,20,3,9,13,19,13,3
0,6,0,6,6,10,6,6,3,0
3,10,6,23,13,6,3,10,3,0
0,3,0,3,3,0,0,3,0,0
