0,0,0,3,0,0,3,0,0,0
0,0,3,13,6,3,20,3,0,0
0,3,3,19,23,3,3,0,0,0
3,10,6,36,6,3,0,0,0,3
0,3,3,23,6,10,6,3,3,13
0,0,0,3,0,9,13,13,6,13
0,0,0,0,3,10,6,3,3,3
0,0,0,0,3,3,0,3,10,6
0,0,0,3,10,3,0,0,6,20
0,0,0,0,3,0,0,0,0,3
