10,3,3,13,13,6,13,23,3,0
6,0,0,6,3,0,3,6,0,0
10,6,3,10,3,0,6,10,3,0
6,10,3,6,0,3,13,6,0,0
0,6,3,20,3,3,23,6,0,0
3,10,6,6,0,0,6,13,3,3
0,6,13,13,6,0,3,13,6,10
3,3,3,6,10,6,3,6,0,3
33,13,3,0,6,13,16,13,3,0
3,3,0,0,0,3,3,3,0,0
