3,16,13,3,0,3,3,0,0,0
3,16,6,0,3,16,23,6,0,0
3,13,6,0,3,13,9,13,3,0
0,6,10,6,0,3,3,13,3,3
0,0,6,10,3,0,3,3,3,13
0,0,0,6,0,3,20,6,3,16
3,3,3,10,6,0,6,13,6,16
13,13,6,6,10,3,3,13,6,16
3,6,10,3,3,0,0,3,3,13
0,0,3,0,0,0,0,0,0,3
