3,0,3,10,3,0,3,0,0,0
10,3,0,3,0,3,10,3,0,0
3,0,0,0,0,0,3,0,0,3
0,0,0,3,3,0,0,0,3,13
0,3,3,16,13,3,0,3,6,13
3,13,6,16,6,0,3,16,13,6
3,13,9,26,3,0,3,13,6,3
3,6,16,16,3,0,0,3,3,13
10,6,13,6,0,0,0,0,3,13
3,0,3,0,0,0,0,0,0,3
