3,0,0,3,0,0,0,0,0,0
10,6,6,20,3,3,3,0,0,3
6,13,16,6,3,13,16,3,6,10
3,6,13,3,3,6,13,6,10,9
13,3,6,3,10,3,3,0,6,10
23,9,13,3,6,3,0,3,0,3
9,13,19,6,16,13,6,13,6,0
10,9,23,6,23,9,3,16,13,3
3,0,3,0,6,10,3,3,3,0
0,0,0,0,0,3,0,0,0,0
