0,0,3,3,0,3,10,3,0,0
3,6,13,16,3,0,3,0,0,3
13,16,12,23,3,0,0,0,3,13
9,26,13,6,0,0,0,3,3,13
10,6,3,0,3,0,6,10,6,3
3,0,0,3,10,6,10,9,10,6
3,0,0,0,6,0,3,0,6,13
10,3,0,3,13,6,3,0,3,16
3,0,0,3,26,16,13,3,3,13
0,0,0,0,3,3,3,0,0,3
