3,0,0,3,13,3,3,3,0,0
13,3,0,6,13,6,16,13,6,0
13,3,3,10,6,3,13,12,13,3
3,0,0,6,3,0,6,13,26,3
0,0,3,13,13,3,3,3,3,3
0,0,0,3,3,6,13,3,3,10
0,0,0,3,3,13,16,6,0,6
0,3,6,13,3,6,6,10,9,13
3,13,16,16,6,10,3,6,13,16
0,3,3,3,0,3,0,0,3,3
