10,9,13,3,3,3,13,6,0,3
6,16,16,6,10,6,16,16,6,20
3,13,6,0,3,0,6,13,3,3
0,6,0,3,0,3,3,3,0,0
6,13,6,10,6,13,23,3,0,0
16,16,3,6,0,6,3,3,0,0
16,6,6,10,6,13,6,13,3,3
16,9,10,6,6,13,6,13,6,10
16,13,6,3,10,6,0,3,0,3
3,3,0,0,3,0,0,0,0,0
