0,0,3,13,16,6,3,16,13,3
0,3,0,6,16,13,9,23,6,3
6,10,3,3,3,6,10,6,3,13
23,9,3,13,6,3,3,3,3,13
16,16,9,16,16,13,6,10,3,6
9,19,13,6,6,6,0,6,3,20
13,16,6,3,16,23,6,10,3,3
3,6,0,3,23,9,0,6,0,0
3,10,3,0,6,10,6,10,3,0
0,3,0,0,0,3,0,3,0,0
