3,13,13,3,0,3,3,3,0,0
3,3,3,0,3,13,26,13,3,0
10,3,3,0,3,6,6,6,0,3
3,3,13,6,13,26,19,13,6,13
0,3,23,3,6,6,16,9,3,13
0,0,3,6,10,9,16,13,3,3
0,0,3,13,9,10,6,3,0,0
3,3,6,13,6,6,0,0,0,0
13,16,13,9,13,13,3,0,0,0
3,3,3,0,3,3,0,0,0,0
