3,20,9,10,6,13,16,6,10,3
3,6,13,6,3,6,13,3,3,3
10,6,13,9,10,6,3,0,6,10
6,0,6,10,9,20,3,3,13,6
23,3,0,6,0,3,0,3,13,3
13,6,3,10,6,3,0,0,3,0
6,10,3,9,13,16,6,3,0,0
0,6,3,10,9,16,16,13,6,0
3,10,3,3,0,3,3,6,10,3
0,3,0,0,0,0,0,0,3,0
