0,3,3,3,10,6,13,13,3,0
3,13,13,3,3,0,6,3,3,0
0,3,3,0,0,3,10,6,23,3
0,3,0,0,0,0,3,6,13,3
6,13,3,0,0,0,3,10,6,3
23,16,3,0,3,3,0,3,6,20
3,6,3,3,13,13,6,3,10,6
3,16,16,3,3,9,20,3,3,0
3,16,16,3,3,10,6,0,0,0
0,3,3,0,0,3,0,0,0,0
