3,0,0,3,0,3,6,10,6,0
10,6,6,10,9,13,26,9,10,3
6,13,16,9,10,12,13,3,3,3
0,9,13,6,9,10,6,0,6,23
6,10,12,13,26,6,0,6,13,16
13,9,20,9,13,3,3,10,9,6
26,3,3,3,3,0,3,9,13,13
13,3,3,23,3,3,13,13,6,3
3,0,3,13,3,0,3,3,0,0
0,0,0,3,0,0,0,0,0,0
