10,3,0,0,3,20,6,13,16,3
3,0,0,3,3,6,0,9,16,3
3,3,3,13,26,16,6,13,16,3
16,13,3,6,6,16,3,3,6,0
26,6,3,20,9,13,3,3,10,6
23,3,0,6,20,6,0,0,6,23
6,0,0,0,3,3,0,0,3,13
13,3,3,0,3,10,6,0,0,3
13,6,10,3,0,6,10,3,0,0
3,0,3,0,0,0,3,0,0,0
