10,6,3,0,3,3,16,13,3,0
9,13,13,9,10,6,16,6,0,3
10,6,6,10,6,3,23,3,3,10
3,0,0,3,0,0,3,0,0,3
0,0,3,0,0,0,0,0,0,0
0,3,10,3,0,0,0,0,0,3
0,0,3,0,0,0,3,0,3,23
3,0,0,0,0,6,10,3,6,13
10,3,0,0,3,10,6,3,10,6
3,0,0,0,0,3,0,0,3,0
