3,10,3,3,13,6,0,3,0,0
3,3,3,6,16,23,9,10,6,0
23,6,23,13,6,6,10,9,10,3
13,6,3,3,0,0,3,0,6,0
6,10,3,0,3,3,0,6,10,6
0,3,0,3,16,23,9,23,12,23
0,0,0,3,13,12,13,29,16,16
0,0,0,0,6,10,6,3,3,6
0,0,0,0,0,3,0,0,3,20
0,0,0,0,0,0,0,0,0,3
