3,6,20,3,3,0,0,3,0,0
13,13,6,3,10,6,3,23,3,3
6,3,0,0,9,10,9,13,6,10
10,6,0,6,10,9,10,6,0,6
6,13,9,10,6,0,6,0,3,10
3,16,13,6,3,6,20,3,0,6
3,6,6,3,13,13,9,3,6,20
13,26,16,3,3,6,13,16,13,6
3,6,13,3,0,0,3,3,3,0
0,0,3,0,0,0,0,0,0,0
