6,20,6,23,13,6,0,3,0,0
10,9,0,3,6,23,6,10,3,0
6,10,3,3,3,13,3,6,3,3
3,6,6,10,3,6,3,16,19,16
13,19,13,6,3,13,9,16,19,19
6,16,6,0,3,26,16,6,6,13
3,26,6,0,0,6,23,6,0,3
6,16,16,3,0,0,9,10,3,0
10,9,13,3,0,3,10,6,0,0
3,0,3,0,0,0,3,0,0,0
