3,13,23,6,0,0,3,10,3,3
0,3,6,10,3,0,0,3,3,13
0,3,0,3,3,0,3,0,3,13
6,10,3,6,10,6,10,3,0,3
10,6,6,10,9,0,6,0,0,0
3,3,13,9,30,9,10,3,0,0
0,3,26,3,6,10,6,3,0,3
0,3,16,3,3,6,6,13,6,10
0,3,13,6,23,26,16,16,3,3
0,0,3,0,3,3,3,3,0,0
