20,3,6,10,3,0,0,3,13,3
6,3,20,6,3,0,0,6,23,3
33,3,6,6,10,3,3,10,6,3
13,6,16,16,9,3,0,3,6,13
3,3,16,19,16,16,3,3,13,16
3,0,3,3,6,13,6,3,3,6
13,3,0,3,0,6,13,16,9,13
13,3,3,10,3,0,6,16,16,19
3,0,0,3,0,0,0,3,6,13
0,0,0,0,0,0,0,0,0,3
