0,3,13,26,16,19,13,6,10,3
0,0,3,3,6,13,6,3,3,0
0,0,0,3,0,3,3,13,3,0
0,0,6,10,3,3,6,13,6,0
0,3,13,6,3,13,13,12,20,3
0,3,13,6,0,3,6,10,9,0
0,0,6,13,3,0,3,9,10,3
0,3,6,16,6,6,13,13,6,3
3,13,16,29,26,13,6,3,3,10
0,3,3,3,3,3,0,0,0,3
