0,6,30,6,10,3,0,0,0,0
3,10,6,0,3,0,0,3,0,0
0,3,0,0,3,0,3,10,3,0
0,3,0,3,10,3,3,3,0,0
3,10,3,3,3,3,20,3,0,0
0,6,3,10,3,3,3,0,0,0
6,10,3,6,3,10,3,0,3,0
13,9,3,13,3,3,3,3,20,3
16,13,6,13,3,3,10,3,3,0
3,3,0,3,0,0,3,0,0,0
