16,13,3,3,0,3,3,10,3,0
13,6,6,10,9,10,6,3,3,3
3,3,10,12,10,9,10,6,13,16
0,0,6,10,9,3,3,0,6,26
0,3,0,6,13,13,3,0,6,26
3,13,6,0,3,3,0,6,23,16
3,16,16,3,3,3,6,13,6,3
0,6,26,6,13,19,19,16,3,3
0,3,13,3,6,16,16,6,3,10
0,0,3,0,0,3,3,0,0,3
