3,10,6,0,0,3,0,3,10,3
0,9,10,3,3,10,6,0,6,0
3,13,6,0,0,9,13,6,10,6
6,13,3,0,6,23,19,6,6,13
10,9,0,3,10,12,19,13,6,13
6,10,6,0,6,13,19,6,0,6
0,6,10,3,3,9,13,3,3,10
0,3,3,3,13,23,6,3,0,3
3,10,3,0,3,3,3,10,3,0
0,3,0,0,0,0,0,3,0,0
