10,6,0,0,3,0,0,0,0,0
6,13,6,6,10,3,0,3,0,0
6,16,16,16,6,0,6,23,3,0
10,6,9,13,3,3,13,16,3,3
3,3,10,9,0,0,3,3,3,13
0,3,6,10,3,3,3,0,3,23
3,10,6,3,6,16,13,3,0,3
0,6,10,6,13,16,6,0,0,3
0,0,3,0,3,3,0,0,3,10
0,0,0,0,0,0,0,0,0,3
