3,6,13,16,6,0,3,0,0,0
13,13,9,16,16,6,10,6,0,0
3,3,3,6,13,6,6,13,3,0
0,6,10,6,6,10,6,13,3,3
3,10,9,10,3,3,0,6,3,10
3,3,3,3,3,0,3,20,6,6
13,6,10,9,10,6,0,9,16,13
13,6,6,23,9,10,6,16,16,6
6,10,6,13,3,3,3,13,6,0
0,3,0,3,0,0,0,3,0,0
