3,10,9,13,3,0,0,3,3,3
0,6,26,19,3,0,3,16,19,13
0,3,19,19,3,0,3,16,16,6
3,3,19,19,3,0,0,3,3,0
13,6,26,16,3,0,0,0,0,0
16,3,3,3,0,0,0,0,0,0
13,3,3,0,0,3,0,0,0,3
3,3,20,3,6,10,3,0,3,10
0,0,3,3,10,6,0,0,0,3
0,0,0,0,3,0,0,0,0,0
