0,0,3,0,0,3,10,3,0,0
0,6,10,3,0,3,3,0,3,0
3,20,6,0,6,10,3,6,13,3
0,3,0,3,10,6,6,26,19,3
0,0,0,0,3,3,16,19,16,3
3,0,0,3,0,3,23,6,6,0
10,6,3,10,3,0,6,6,10,3
6,13,3,3,0,3,16,23,9,0
3,13,3,0,0,3,13,9,10,3
0,3,0,0,0,0,3,0,3,0
