0,0,0,3,6,13,13,3,0,0
0,0,3,13,13,6,3,0,3,0
0,0,0,3,3,0,3,3,10,3
3,3,0,3,3,3,10,6,3,0
13,16,6,16,16,6,6,10,6,0
6,13,6,19,19,13,3,6,20,6
0,6,3,13,6,6,0,0,6,10
6,13,3,3,3,10,3,0,0,3
13,16,3,0,0,3,0,0,0,0
3,3,0,0,0,0,0,0,0,0
