20,6,16,16,13,6,20,6,0,0
6,6,13,6,3,0,6,10,3,0
13,16,6,3,0,3,0,3,0,0
6,13,9,10,6,10,6,3,0,0
0,9,10,6,0,6,13,13,6,0
3,10,6,0,0,0,6,6,10,6
3,3,3,3,3,3,23,3,6,23
10,6,26,16,13,9,13,6,6,26
3,3,23,6,6,10,9,13,16,16
0,0,3,0,0,3,0,3,3,3
