13,26,6,3,20,6,6,10,3,3
6,29,16,6,6,16,13,9,3,13
3,16,19,23,6,13,12,10,6,13
0,6,6,6,3,6,20,9,0,3
3,13,16,16,16,6,6,10,3,0
0,6,3,9,16,13,3,6,0,0
6,10,6,10,9,3,3,10,3,0
10,9,3,9,10,3,3,3,0,0
6,13,16,13,6,3,10,3,0,0
0,3,3,3,0,0,3,0,0,0
